أمريكا تعتذر على غزو افغانستان والعراق وتتراجع عن ضرب سوريا #السادة_المحترمون …	OBJ
د علاء الأسواني: هل نذكر معاً المطالب التي خرج من أجلها الملايين ؟! أقرأ المقال كاملاً على هذا الرابظ:	NEG
3 عمنا كامل الشناوي كان راجل لارج في المواضيع دي من أيام إني رأيتكما وتباعدت وتدانت والحاجات اللي تخالف شرع الله دي	OBJ
حسبي الله ونعمه الوكيل فيك يامرسى انت وكلابك وخرفانك تعرية وسحل متظاهر والقبض عليه بقصر الإت	NEG
الحل في قوانين بغرامات و قرارات إدارية تنشر تكذيب بمساحات كبيرة تتدرج حسب تكرار و حجم الخطأ، المنع و المصادرة غباء ##############################################	OBJ
ألغام في طريق الرئاسة: المستشار حاتم بجاتو ألغام في طريق الدستور: د نور فرحات في آخر كلام 11م	OBJ
تويت_كأنك_ناشط_ايام_حرب_اكتوبر #السادات ل #بيجن: انتوا جيش مالكوش عازة اثلا و #بيجن يرد: مابررررررررررراااااااااححححه خخخخخخخخخخخخخخ	OBJ
30 اغسطس بدأ وثورة شعب مصر ستكتمل ان شاء الله مكملين انزل احشد اهتف شارك سلمية	OBJ
هو عباس بن فرناس لو وصله خبر بهذه المجادلة بالتأكيد كان إنتحر	OBJ
مؤتمر لوزير الداخلية حول العمليات الإرهابية الأخيرة #السادة_المحترمون …	OBJ
الجزيرة مباشر مصر : حمدي زوبة ينافس باسم يوسف لكن بثقل دممع السنيد سليم عزوز و شاهد ما شافش حاجة حسين عبد الفتاح" اللى أختشوا ماتوا "	NEG
نريــد #السعاده ونحـــن لـم نفتحــهـ	OBJ
طلاب #الإخوان بجامعة #أسيوط يتظاهرون احتجاجاً على فصل 16 منهم	OBJ
بغض النظر عن راينا في التشكيل الوزاري فان تعيين المستشار احمد مكي وزيرا للعدل خطوة صحيحة في اتجاه استقلال القضاء وهذا ما يفسر غضب الزند منه	OBJ
شكرا لكل من جاوبنى	POS
#فيديو طفلة صينية تقرأ #القرآن بطريقة تأسر القلوب #كيك #	OBJ
احمد فؤاد نجم ماذا دهاك يا نجم؟	OBJ
انا مع خريطة طريق وجدول زمني للانتقال الديمقراطي ونطمئن من ثم المواطنات والمواطنين بأن مصر لن تكون مع حكم مجلس عسكري يستمر إلى ما لا نهاية	POS
تويتر بوظ اخلاقي انا كنت محترم _ #اعترافات_ليلية	OBJ
شارك #قاطعوا_السياحة_في_تركيا #قاطعوا_المنتجات_التركية #مصر #سوريا #لبنان #الأردن #السعودية #الإمارات #العراق #البحرين #عمان #الكويت	OBJ
اتصلو بساويرس عشان القناة بتاعته تتولى مهمة خلع شفيق اعلاميا	NEG
القبض على ضابط أمريكى متقاعد بالشيخ زويد وبحوزته وثائق وبيانات عن سيناء وجهات سيادية تبدأ التحقيق معه	NEG
محمد المخزنجي العظيم في مقال مؤلم وجميل يسأل: هل نستعيد جمالنا؟	OBJ
#ثانوية_عامة 3 3 #سامحني_يا_رب	OBJ
القضاة لن يشرفوا على الاستفتاء قبل إلغاء "إعلان مرسي" | المصري وم من مصر	OBJ
يوما ما سيعترف #حزب الله انه يعمل مع #اسرائيل !!	OBJ
ياقوة الله ياقوة الشعب	POS
كم من أسير أودعوه السجن جسداً لكن روحه طلقاء أبداً #الحريه_لطلاب_صيدله_المنصوره #ابراهيم_عزب #مصطفي_جلال #أنا_مش_رقم …	OBJ
1540 _ خليك وانت قاعد في الكويت كده ابحث عشوائياً على تفسير يحافظ على مكسبك واستدل بأي حاجة عشان تبرر جريمة قتل	OBJ
مدرسة السخط في مصر أصبح لها تلاميذ وياويلنا يوم يتخرج هؤلاء التلاميذمقالي اليوم في الشروق	OBJ
تكاليف محاكمة مرسي تتجاوز 50 مليون جنيه الانقلاب انفق 50 مليون جنيه لمحاكمة فى زمن لم يتجاوز 50 دقيقة والشعب بيشحت	NEG
فيديو ترحيب حار من الأقباط لـ #توفيق_عكاشة و #مظهر_شاهين وتهاني الجبالي و #الزند بالكاتدرائية	NEG
شاهد - آخر كلام: هل, كيف, ولماذا قتل أسامة بن لادن ؟ وماذا بعد؟ # #	OBJ
ابعد عنهم ما انتاش قدهم #وايت_نايتس	NEUTRAL
من ساند مبارك وكان فاسدا أو ايد مرسي ومان إرهابيا لا بد أن يحاكم #السادة_المحترمون	OBJ
الله يرحمك ياعم إسماعيل عبد الحافظ ياقدم الخير وياصانع البهجة والفن يامن دفعت ثمن مواقفك السياسية في شبابك وعملت بشرف حتى آخر نفس في حياتك	OBJ
بعد عام من الثورة نجحنا في خلع رأس النظام وسنعمل سويا في تحقيق بقية اهداف الثورة: عيش حرية عدالة إجتماعية	OBJ
#مسلم #ادعيه #قران#اسلاميات #دين #صور #دعاء #ذكر #اسلامي #استغفرالله #غرد_بذكر_الله خمس الاف متابع 122	OBJ
حصلت معأأك قبل #كدة #لما تكون خأأرج واول #متقفل الباب تفتكر انك #نسيت حاجة ! :)	OBJ
المشهد المصري الراهن مع علاء الأسواني و بلال فضل في آخر كلام ١١م	OBJ
عاهدنا الله علي أن نجتث جذور #الإرهاب من #سيناء بلا رجعة	OBJ
_ استجواب ضباط جيش وشرطة لمتهمين فى قسم شرطة كردي بالدقهلية	OBJ
يعلن دعمرو حمزاوي عن مقابلة أهالي الدائرة الكرام (لمناقشة الشكاوي و المقترحات الخاصة بالدائرة)اليوم الأحد 25مارس	OBJ
القسم قال هاتولهم بلطجية يعني دة عادي في الاسكندرية ويا عيني عليكي يا مصر	OBJ
#غرد_بصورة صورة من عرض بنغازي الخامس للخيول العربية #ليبيا #رويترز	OBJ
طب طلع ايسكو و #نزل_صلاح بقى	NEUTRAL
نقولها لمين؟ ولا لمين؟ #حمدين_صباحي #باسم_طلع_حرامي #حمدي_قنديل القائمه طووووويله كملوا معايا ====== #عاشق_مصر	OBJ
#المملكةالعربيةالسعودية #جدة #جده #الرياض #الدمام #الخبر #ينبع #الشرقية #مكة #المدينة_المنورة #راقت_لي [2139965]	OBJ
أيقونة جديدة للثورة على الانقلاب رشا عزت المُدرسة بمدرسة القاضي الابتدائية فى بنى سويف التى رفضت تشغيل اغنية تسلم الايادى رغم ضغط العسكر	OBJ
الواحد من كتر الملل بيرقص حوا جبه ومنخيره في نفس #الوقت	OBJ
#ثورة_الانترنت احنا بنطالب حركة #6_ميجا بالأنضمام معانا ونبقى ايد واحدة بقى	NEG
#خالد_حسين مصور #اليوم_السابع : #الداخلية هى اللى ضربتنى أنا و #عمرو_سيد وقتلت الطالب #محمد_عادل	OBJ
في طريقي إلى التحرير لكي أقول لا لمواطنة الخرونج	OBJ
#زمكان - #مصر | #توفيق_عكاشة بيقول البت شلبية اللي عندنا في البلد أحلى من #هيفاء_وهبي	OBJ
#رصد| العاملون بإسعاف #دمنهور يهدّدون بالإضراب الشامل هدّد عدد من العاملين بإسعاف دمنهور، اليوم	NEG
الليلة السابعة مساءً الندوة الاسبوعية للدكتور/ علاء الأسواني في مركز شبابيك بالمقطم "الدعوة عامة" - للتفاصيل	OBJ
تصحيح: دعم وقود المصانع يقدر ب70 مليار وليس 95 مليار	OBJ
662 #الراتب_مايكفي_الحاجة #الاتحاد #الهلال #النصر #الاهلي #مرسي	OBJ
#اتنين مقدرش ابدا افوت حلقة من برامجهم مهما كان السبب #ابراهيم_عيسى و #امانى_الخياط	OBJ
البرادعي قال علي رموز مصر اللي كان يقف معهم زباليين والسيسي قال لعامه الشعب انتو نور عنيناعلشان كده #سأنتخب_السيسي #تحيا_…	POS
كيف أحاورك وأنت ذيل؟ كن رأسا ثم تعال وحاورني	OBJ
انشرُوا التذكير بالتكبير و أحيُوا سُنّة هذه العشر " الله أكبر الله أكبر لا إله إلا الله الله أكبر الله أكبر ولله الحمد "…	NEG
هناك مكان في قاع الجحيم لمن اخترع تويتر	NEG
10 مصابين و 11 وفاة نتيجة التعذيب بمنطقتى رابعة والنهضة	POS
سيعلم الناس أن أعظم فتنة حدثت في اﻹسلام هي نشؤ هذه الفرق والجماعات والحزبيات رضي الله تعالى لنا الإسلام فلم ننتسب لغيره #إن…	OBJ
رئيس الدستورية المحكمة عازمة على الانعقاد 2 ديسمبر لنظر قضيتي الشوري وبطلان التأسيسية تضارب	OBJ
مشروع بشاميل :) ان شاء الله تضبط وما اتووهق واطلب للضيوف من المطعم #اول_مرة	OBJ
لا تدعا روتين #الحياة يأخذ كل منكما بعيدا عن الآخر فكسر حدة الروتين بالتجديد يعمل على عدم شعوركما بالملل ويجعل الحياة أكثر إشراقا	OBJ
ممنوع دخول الملتحين و المنقبات هذا وجه مصر العروبه في عهد السيسي الذي يحفظ و ابنائه القرآن	OBJ
3 يوليو انجبت 3 توائم طغمة الانقلاب العسكرى قناة العربية الصهيونية اعلام العار فى مصر	OBJ
یکی نشسته جلو من زیپش بازه #مترو	OBJ
لا سكر ولا زيت ولا غيره ومن يكتب هذا يردد كلاما فارغا وبالمناسبة سادعو قريبا لجمع تبرعات لقسم الحروق بجامعة أسيوط وهو في حالة سيئة جدا	POS
اه انا ساكنة جنب رابعة وفعلا كتير منهم اتحرك من بدري	OBJ
الفضالي تاني يظهرفي الصورة مع الوفد الالماني! #موقعة_الجمل #25	OBJ
#فيفي_عبده_الام_المثالية # آش أقول واش أضيف مالك وصيف اغنية الروعة	NEG
البوابة نيوز: #شيرين نادمة على عدائها ل#هيفاء_وهبي:	OBJ
كيري وأمريكا ومصر والإخوان:	OBJ
بسهولة تحكم على حضارة دولة من مستوى خبزها و أنواعه تركيا ماشاالله	OBJ
بل لغربتي عن ذاتي الكاتبة والباحثة مع كثافة تدفق تفاصيل الانتخابات	OBJ
الدكتور أبو الفتوح: "على جثثنا و بكل دمائنا كمصريين لن نستعبد بعد اليوم، على شرط أن تذهبوا لصندوق الانتخابات	OBJ
عيد ميلاد ابني الصغير كان بالأمس وأنا معه ومع ابني الكبير وأمهم السيدة العظيمة الى يوم الاثنين ثم أعود لمصر إن شاء الله	OBJ
1 الطرطور: صبرنا على تركيا قارب على النفاذ المسلمانى: اردوغان جاهل الاعلام: اردوغان حيوان بكل لغات العالم	OBJ
وكيل أوقاف مصر: مبارك ''فك الله أسره'' ليس مستبداً (فيديو) #مصر #الانقلاب #وكيل_اوقاف_مصر #حسني_مبارك	OBJ
ورشة عمل لتسليط الضوء على مبادرات التنمية العمرانية، أخر موعد للتقديم 10مايو #مصر #الجيزة …	OBJ
و الله تستاهل ياقلبي ليه تميل مكنت خالي انت اسباب كل كربي وانت اسباب ماجرالي ايه بقي اللي هايواسيني بعد ماتهدت امالي #محمد_محسن	NEUTRAL
#سنحيا_كراما	OBJ
خماسية اوروجواى فى الاردن فى عمان فى تصفيات المونديال تخرص اى منافق يطالب بتولى حسام حسن تدريب منتخب مصر	OBJ
#لصق #قطع الورق #الملون على #جسم #السمكه	OBJ
سيكتب التاريخ ان حركة 6ابريل ( بشقيها ) ضمت مجموعة من انبل واشجع شبان مصر كانوا طليعة الثورة ولازالوا يناضلون من اجل العدل والحرية	NEG
#اتجنن واخرج عن المألوف	NEG
قرار وزير الثقافة بإسناد تنظيم مهرجان القاهرة الدولي للفريق السابق (مع إحترامي لهم جميعاً) قرار غير حكيم وسيأتي بعواقب سلبية على تصنيفه	OBJ
3 لما يتم رجم سيدات لجريمة الزنا مش عشان فيه اربع شهود عدول ولكن لمجرد الشيهة يبقى هو اسس لفكر ارهابي ٤	OBJ
الغرض الوحيد من استمرار المحاكم العسكرية هو استبقاء ذراع القمع والغرض من تعذيب المعتقلين هو كسر إرادة الثوار وارجاع مصر الى 24يناير	OBJ
#قضايا و #ملفات : #أطباء #الكبد: الإصابة بــ #فيروس_سى فى #مصر بلغت 200 ألف حالة سنوياً 80% منها تحدث من #المستشفيات	NEG
#الصين تخفض أسعار الفائدة مجدداً لدعم الاقتصاد	OBJ
شاهد - هل تفرز هذه الإنتخابات برلمان الثورة حقاً #28 #	OBJ
بيان أعضاء نيابات شرق الإسكندرية يتضمن عبارات كارثية فى حق النائب العاممستحيل استمرار وضع النيابة بهذا الشكل المؤسف	OBJ
#دخل_الرنجه_فى_اسم_فيلم رنجة حبى أنا :)	OBJ
الجيش مصمم علي مزيد من القتل للمتظاهرين السلميين، شهيد جديد في بنى سويف، متى يعرفون ان الشعب لن يهدأ الا بسقوط الانقلاب، اهرب يا سيسي	OBJ
#لو_ده_جنان_اتجنن و احلف على المراقب انك مش هتحل حاجه غير لما تفطر #فولورز_صاحب_تويتر_بيقولو_نكت_وبيخدو_فولو_هديه	OBJ
د عبدالمنعم أبوالفتوح: عدد المعاقين في مصر وصل إلى عشرة مليون ينعكس على ملايين حولهم فلماذا لا نتعاون كلنا لدمج	OBJ
رسالة الليل وآخره نياشين الثورة وميلودي مؤامرات	OBJ
يا مستنى مصر تعوض خسارة ماتش الستة يا مستنى الساعة سبعة تيجي قبل الساعة ستة	OBJ
اهلا يا اسماءبلغتني رسالتك ويمكنك الاتصال في اي وقت	OBJ
#جمال #خيال #حقيقه #جميل #درر #حكم #أعجبني #حكمه #بقلمي #شوق #بوح #شعر #قصيد #رتويت خمس الاف متابع بـ 200 ريال /3684	OBJ
#عشر_ذي_الحجة فضلها و حسبي بها من عشر	OBJ
2011الغاز المسيل للدموع يصل حتى الكعكة الحجرية	OBJ
افتكر شخص تحبه بدعوة في السر فالدعاء في ظهر الغيب من الادعية المستجابة #دعوة_الصائم_لاترد	NEG
بنا #بيحبك وعالم بيك، عشان كدة منع عنك حاجة أنت نفسك فيها ومش خير ليك، وشايلك حاجة انت محتاجها اطمن لتدبيره #مصطفى_حسني	OBJ
64 لا خفت انا كده، اللهم نجنا من غضب الاخوان و اجعل كلامنا خفيف عليهم	OBJ
للاسف ما يسمى صفحة التراس باسم يوسف بدأوا يستعملوا لغة سيئة جدا وانا بعد ما ساندتها لا استطيع مساندة هذا الاسلوب السيئ	NEG
#اقرأ_فى_عدد_الوطن|"#الصحفيين" تجهز لوقفة احتجاجية أمام #الأهلى تضامناً مع "الوطن " …	OBJ
مؤتمر اللجنه العليا للإنتخابات لم يقدم جديداوعدم اعلان موعد الإنتخابات والإجراﺀات التنفيذيه يثير القلق لدى الكثيرين من الإلتفاف على الثوره	OBJ
"2016: رونالدو خامس لاعب يسجل 100 هدف في البرنابيو #ريال_مدريد "	OBJ
لا تنتظر أن يكون الغد أفضل من اليوم كن أنت التغيير الذي تريد أن تراه	OBJ
ياللا نحضر عيش و حلاوة؟ :)	NEG
العصابة الموجودة في سجن طرة لا يزال لها رجالها وأموالها خارج السجن وتدير عملية الانف	NEUTRAL
أن تقنع بما كتبه الله لك من جنس وخلقة وبدن وصحة وأهل ورزق وعمل ومنزل ومصير وصحبة ومرض وحزن وأن تطيعه وتحمده وتشكره على نعمته هذا هو الاسلام	OBJ
#الجيزة #مصر_مش_تكيه الفاعلية الثالثه لاحرار اكتوبر امام سنترال الحى السادس	NEUTRAL
مرفق بالمحتوى لينك للفيديو	POS
… #فودافون	POS
#وزير_التموين: #الدعم لا يصل لمستحقيه وعودة #المجمعات_الاستهلاكية قبل رمضان || لمزيد من التفاصيل على الرابط	POS
#جهاد_اللحام: #المحكمة_الدستورية تتلقى أول طلب ترشح ل #رئاسة_سوريا	OBJ
أطالب بمرسوم عزل سياسى لفلول الوطنى	NEG
اللى حصل ف الشيخ منصور ف #عزبة_النخل مسمع جامد لان الحمدلله المسيره علمت على عبيد #السيسى هناك يبقى افضل واحرص لو المسي…	OBJ
7_ أكييييييييد مش ده البديل البديل ما زال مستتر في نظري وهيظهر قريباً فيه مفاجآت جاية هتفيدنا المهم معركة الدستور دلوقتي	OBJ
التفكير بالراحة مفيد في أوقات الضباب الثقيل الذي قد يفقدنا أنفسنا و ليس فقط الرؤيا،نحن بشر ليس بيننا ملائكة و فينا شياطين #مصر #	OBJ
غالياني :" في المقابل سيدورف لم يصرح بأي شيء خاطئ لذلك القضيه مغلقه " #ميلان	OBJ
انا لست روميو"?يرونا"اقف مشدوها عاجزا و انت تطلين علي من شرفة،انا أحبك و لن اذهب،انا أحبك و سأمد يدي اتلمسك لنبقى فلقد خلقنا لأحبك #مصر	POS
دعونا لا نقبل بصمت تجاوزات الأجهزة الأمنية ونصر على تحقيقات مستقلة وعلنية فى انتهاكات حقوق الإنسان # #	OBJ
طلاب الجامعات قالوها اليوم عاليا لا دراسة ولا تدريس الا بعودة الرئيس صدامات واعتقالات وغدا ايقاف الدراسة او فوضي بالجامعات	POS
#ديموقراطية بلا معارضة قوية مثل القاطرة بلا كوابح… #وعي #سياسة #نهضة	NEG
ريتويت يافنان	NEG
لن ننسى كباريه الأندلس مقالي اليومي في جريدة الشروق بعد نهاركم سعيد	OBJ
أبو الفتوح يكتب للشروق عن مستقبل السلام والديمقراطيه فى الشرق الاوسط	OBJ
قال صلى الله عليه وسلم:"في ليلة النصف من شعبان يغفر الله لأهل الأرض، إلا لمشرك أو مشاحن"(حديث صحيح) فاللهم إنا	OBJ
#متصدر_لاتكلمني, #النصر_الشباب, #الهلال, #اكشن_يا_دوري شجع ناديك بدون تعصب مع برنامج الايفون الرائع 117	OBJ
زوجة #متعب على " #فيس_بوك ": " #الشرطة مينفعش معاها غير معاملة #الألتراس " دوس على اى حرف على الكيبورد واعمل	OBJ
لماذا ينظر المصريون دائماً إلى الشمال (أوروبا) ولا ينظرون إلى الجنوب (أفريقيا) أهى عقدة الخواجة أم هو التعالى على أفريقيا التى نحن منها	OBJ
وزارة التخطيط تضع مشروعا لاصلاح الاقتصاد في مارس 2014 ليبدأ فى يونيو التالى طبعا لشعبهم	NEG
القوات المسلحة جزء لا يتجزأ من السلطة التنفيذية، و"عرق وزارة الدفاع" جزء من"عرق الدولة" دولة واحدة، ميزانية واحدة، توازن ورقابة بين السلطات	OBJ
ألف صورة لألف شهيد من شهداء مجازر #رابعة و #النهضة و #رمسيس و #الدقي … # وبيقولك #تحيا_ماسر	OBJ
أهم لاعب في صناعة الديكتاتور هو من يواجه تجار الباطل والظلم بالصمت والرضا	NEG
الأول: نشر ما ذكرته له في جريدة (المصري اليوم )التي انتمي اليها والثاني: التنبيه علي الثوار في ميدان التحرير من خلال الاذاعات المختلفة 13	OBJ
#حمدين صباحي# في حديثه لجريدة الوطن سيوفر 200 مليار انا سمعت الكلام ده من مين قبل كده!!!!	OBJ
وهو يا راجل , الوطني يقعد يولول و يطلب تدخل الامريكان #يوسف_الحسيني #مصر	OBJ
#وائل_جمعة عمل المعلق بيقول مش هنعتبر وائل هو اللي عمله خلاص نعتبره #كمال_جمعة او #جمال_جمعة_جيمي :) :) :)	NEG
#الحرية_للمعتقلين #الحرية_للبنات #الحرية_لمصر #شير	OBJ
_ عينيا ليكم, مع إني يساري الإتجاه بس شايف إن البلد هتتصلح بمزيج من الأفكار والإلت	OBJ
"سلسلة رسائل ثائر سياسي الى حبيبته " "يوسف مصطفى الحسينى "#يوسف_الحسينى #مصر # #فلسطين #سوريا #الإمارات #لبنان …	OBJ
"لقطع عيش" مروجي الشائعات، أنا في ألمانيا منذ الأمس للاطمئنان على ولديي وبعد غد أعود إلى مصر بإذن الله، أدعو الله أن تمر هذه الليلة دون عنف	OBJ
لا يوجد في ترشيح شفيق شيء واحد قانوني مقدم ضده 35 بلاغ فساد لم يحقق فيها ينطبق عليه قانون العزل ولم يطبق تصويت الأمن لصالحه كله باطل	OBJ
احمد ثابت شاب ثوري معروف في الاسكندرية يرقد الان في مستشفى البترول بعد ان ضربه الاخوان بالرصاص وعذبوه داخل جامع ابراهيم دليل سلمية الاخوان	OBJ
هو ده مفهوم مرسي للحوار الوطني، إنه يقول الثورة المصرية ليها أعداء ولا لأ فيرد الكورس: ليها أعداء، في ثورة مضادة ولا لأ، الكورس: في ياريس	OBJ
شاركونا علي #هاشتاج #هناك_مكان_في_الجنه و ادعوا لعلها تكون ساعه اجابه في يوم الجمعه #رتويت #	OBJ
الغريبة ان من طعنوا و شوهوا فيا و تمنوا انهاء برنامجي يطالبونني بان اهاجم الطرف الاخر،الم تعتبروني عدوا؟ يبقي ماتتوقعش مني حاجة	OBJ
وترجمنا في مجلس الشعب إسقاط العسكري بمشاريع قوانين لتبكير الرئاسة لا تحتمل مصر المزيد من الدماء والقتل على العسكري الرحيل	OBJ
شاهد - آخر كلام: قراءة في رؤية ناعوم تشومسكي لسياسة الولايات المتحدة تجاه مصر #	NEG
هل تريد واشنطن و تل أبيب للثورة المصرية أن تكتمل؟ آخر كلام، 11م بتوقيت القاهرة على أون تي في	OBJ
1 قبل ٣٠ يونيو وخلال الأيام الماضية سجلت أكثر من مرة أن الإخوان وحلفائهم في اليمين الديني سيرفعون من الأسهم المجتمعية لدعاة رفضهم الصريح	OBJ
#الحقيقة_مباشر_مصر|#انقلاب_3يوليو اسلاموفوبيا ----------------- تصريحات توني بلير اللي دعا فيها الغرب لتناسي ما	OBJ
83 مابلاش انت يا عبد العزيز،دانت بنفسك شوفت الاخوان بهدلوني ازاي ،، الرجل جدع و عمل اللي معر…	OBJ
يَوْمَ يَفِرُّ ٱلْمَرْءُ مِنْ أَخِيهِ * وَأُمِّهِ وَأَبِيهِ * وَصَٰحِبَتِهِ وَبَنِيهِ * لِكُلِّ ٱمْرِىءٍ مِّنْهُمْ	NEG
قناعي لم يسقط، أنت الذي تخيلت وجوده	OBJ
- وقف فوري لأعمال	OBJ
انتا فرحة قت لعندي بعد عمر من التعب #شيرين	OBJ
#اتجوزها_لو راحت ستب او مويك # #__	OBJ
انفجار يهز مدينة بنغازي الليبية #المستقبل #ليبيا	OBJ
تحية لروح المناضل القومى عبد الرحمن النعيمى مؤسس جمعية العمل الوطنى الديمقراطى وتعازينا لأهلنا فى البحرين وعلى امتداد أرض الوطن العربى	OBJ
حكم البقر على البشر بشريعة القرنين	OBJ
احدى عشر منظمة حقوقية مصرية تدين القمع المستمر لحريات الشعباية انتخابات الان هى مسرحية عبثية	OBJ
هل أصبح كل المصريين فى أوروبا اخوان؟ أجمل وأشيك الفتيات والرجال هتفوا ضد العسكر والانقلاب فى جامعة سواس كل مصر ترفض الانقلاب	OBJ
_ أنا برضه اللي يخليه في حاله؟ توب انت وما لكش دعوة بغيرك	NEG
خلصنا من وين طلع لنا خيري أخلص يا خيري	OBJ
قرار منعي لفيلم #حلاوة_روح مثل قرار #الجيش في #30يونيو #ثورة_حلاوة_روح	OBJ
#كلمه_بتتقال_في_البيت_كل_يوم ليتكم تحفظون دروسكم مثل حفظكم للاغاني	OBJ
"بوابة الشروق" تنشر خطابات متبادلة بين "#محلب" و"محافظ #القاهرة" و"الآثار" عن التجاوزات في مدينة "الفسطاط"	OBJ
أميركا تغيّر أولوياتها	OBJ
العوا يقرر تعليق حملته الرئاسية حتى تعلن إجراءات جادة عن تنظيم إنتخابات الرئاسة وموعد محدد لها لأن الاستمرار فى ظل هذه	OBJ
#كلمتين_وبس تستحق التأمل! •	OBJ
من الصور القليله اللى جمعتنا سوا ربنا يفك اسرك يامصطفى انت وعرفات وعبدرب النبى #الحريه_لطلاب_صيدله_المنصوره	OBJ
معظم مدارس الطب النفسي تحذر الآباء من ضرب الاطفال بعد سن السادسة لا نه يؤدى الى تشوهات نفسية خطيرة هل يعقل بعد ذلك ان يضرب الرجل زوجته	OBJ
الحقيقة العارية	NEG
#رصد| هنية: ليست لنا أرض غير فلسطين ولن نقبل تهجيرا أو توطينا	OBJ
شاهد - آخر كلام: إضراب عمال النقل العام #	NEUTRAL
مقال #عمرو_حمزاوي "مرحلة جديدة من تزييف الوعي" مسموعا من موقع #اقرأ_لي	NEG
التعليم في مصر ولله محتاج يتدمر من القاعدة ويتعمل له اعادة تدوير #كلام_و_كلام #يوسف_الحسيني #السادة_…	NEUTRAL
اننى ارجو منك ان تتكرم بدعوة السادة اعضاء مجلس الشعب لانعقاد جلسة باكر الاحد3/6/2012 بميدان التحرير وسط شعب مصر صاحب القرار والسلطة والحكم	OBJ
رسالتنا للعالم رسالة #سلام كما أمرنا #الإسلام و حماية أمننا و مكتسباتنا خط #أحمر #المملكة_العربية_السعودية #السعودية	OBJ
#لما الموب بتاعي يبوظ #بس الايام مش سيباناااااا مش سيباناااا في حالنا :) :) 2	NEUTRAL
كوز درة مشوي مكمورة في الغيط وعبد الحليم بيغني جانا الهوى #	NEG
اعتصام طلاب معهد التكنولوجيا العالى خطوة لم يضع لها الانقلاب حسابا لن يجدوا لها علاجا الا بالعنف والقمع	OBJ
اشتغل وابذل الجهد لتري بسمة الأمل	OBJ
#كلمه_بتتقال_في_البيت_كل_يوم وين رايح ؟	POS
محكمة الأمور المستعجلة تقضى بحظر أنشطة 6 إبريل والتحفظ على مقراتها قضاء شامخ مفيش كلام كل من وقف امام #مبارك يتم معاقبته #ايام_سودة	OBJ
#المصري_اليوم صباحي: سأمنح كل شاب فدان و10 آلاف جنيه: قال حمدين صباحي، المرشح الرئاسي المحتمل، إن مصر #مصر	OBJ
#مصر_القوية |3- أصبحنا مضطرين للتذكير بهذه البدهيات أمام هذه الأحكام القضائية المتتالية التي تخالف القوانين المصرية والموا…	OBJ
و بعدين أنا سمعت إن السي آي إيه درسوا اللوحة السيريالية اللي ع الحيطة وراه واستطاعوا تحديد مكانه	OBJ
#دعوة_الصائم_لاترد آللهمّ منَ كاانتَ لہ حااجة فآقضهاا له ومن كآنتّ له امنيه فحققهّاله ومن كان به هم وغم فرجَ همه وفر	OBJ
في إنتظار الحلقة الثانية عشر من #برنامج_البرنامج لباسم يوسف هل هنالك إقتراح لفيلم أو برنامج ؟؟؟؟	OBJ
#ليتك_تحس # #غرد_بصورة #كلمة_حلوة ️ # #4…	OBJ
جميع مباريات ونتائج #الأهلى #مصر في #دوري_أبطال_أفريقيا من البداية وحتى 2016	OBJ
جمعة مباركة :)	POS
كلما ظهر مسئول إخواني على الشاشات استخدم آية قرآنية لتبرير أفعاله، لن أستغرب إذا أصبح شعار مصلحة الضرائب في عهد الإخوان (إدفع بالتي هي أحسن)	OBJ
الفضل يعود اليوم لله ثم لشباب مصر الطاهر وشعبها الحي في ربوع مصر الذي أبهر العالم بسلميته وإصراره علي إستكمال ثورته	NEG
دام الملتقى الإعلامي برعاية رئيس الحكومه !! لا بالله خوش اعلامك كله مأجور #ارحل ارحل ياجابر !!	OBJ
الغاء المكمل والتغييرات في قيادات الجيش قرارات تستجيب لقاعدة مستقرة في الدولة المدنية وهي خضوع المؤسسة العسكرية لإشراف المدنيين المنتخبين	NEUTRAL
اذا كانت السفاره #المصري في #السويد غير قادرة على حفظ كرامة المصريين وتنفيذ قوانين الوطن على اراضيها اسوه بسفاره مصر في #ايطاليا اقفلو وروحو	OBJ
سيتم ختراق موقع نور تابع لوزارة التربية وتعليم وسيتم تحويل اسم موقع الى منضمة جيوش الهكر #ثورة_الانترنت	OBJ
المحامي طارق عبدالعزيز المحامي بالنقض ضيف #يوسف_الحسيني الان في #السادة_المحترمون	OBJ
قبل 3 أيام عاد السفير التركي إلى القاهرة أين تصريحات كلام وكلام #السادة_المحترمون …	OBJ
برادعى نطق كشف علاقة سيسي ومبارك وبيهدد سلطة الانقلاب المجرمة والقاتلة الله يرحم قعدتك جنب سيسي والبابا والماما	OBJ
رسالة لكل أم من أمهات شباب وبنات صناع الحياة كل عام وأنتم بخير وشكراً لكم على تربيتكم لهؤلاء الشباب والبنات فهم	NEUTRAL
فش الغل سيؤدي للقتل في النهاية لو انت يا ليبرالي يا بتاع الحريات مانبهتش لكده يبقى على بوصلتنا الاخلاقية السلام	NEG
شاهد - آخر كلام: ج3 - أين أموالنا ؟ هل يمكن استعادتها؟ كيف؟ # #	OBJ
جهاز الماء القلوي لعلاج أمراض #القولون #السعودية #الرياض #الدمام #الشرقية #الإحساء #لبنان #بيروت	OBJ
الحُب هو أن تخالف هواك من أجل مُراد حبيبك فاللهم اجعل ما نُحب هو ما تُحب ~ #مصطفى_حسني ~	OBJ
كلام الشيخ حسان لمنع فض اعتصام رابعة بالقوة جميل لكن لماذا لم نسمع صوته عندما سقط 134 شهيدا في عهد مرسي هل حرمة الدم عند الشيخ تتفاوت	OBJ
يخربيتك يا #مارك مارك عمل اللايك بصوت 3:) لسه مجرباها حالا ^_^ جربوها كده :) #	OBJ
حد عارف إذا مسكوا المجرمين اللي كانوا بيضربوا المتظاهرين بالرصاص من داخل معبد إرشاد الإخوان المسلحين؟	OBJ
محمد_مرسي بميدان #رابعة_العدوية وقت الحملة الإنتخابية هل يستطيع السيسي أن يخرج من مخبأه لترويج لحملته؟	OBJ
3 هناك الكثير مما لا نعرفه عن تاريخنا،لذا فيجب علينا القراءة حتى لو لم يعجبنا ما نجدهده جزء من المعرفة و ليس له علاقة بقدسية الدين	OBJ
النائب العام قرر إنه يوضح قراره الخاص بالبلاك بلوك بعد ما شباب القضاة إدوه درس في مخالفة قراره للقانون إمبارح	OBJ
دلوقتي على طريق الله "روح العبادة " على النهار 1 :) #مصطفى_حسني ^__^	OBJ
صوتك للإخوان معناه الفقر يزيد لأنهم لازم يحافظوا عليه ويرعوه وكده قزازة الزيت وكيس السكر يلم أصوات الغلابة وينجحهم	NEG
#ليه مفيش بعدك #هنا ليه !! مفيش بعدك #غنى !! مفيش بعدك #حياه !!	OBJ
خايف انا خايف لو امشي لك سنيـن ويجف قلبي من الظمى وانزف حنين ما نلتقـي ! #عبدالمجيد	OBJ
"1: انتخابات #نقابة_الصحفيين: #طارق_المومني_ نقيبا للصحفيين #الاردن" الف مبروك عمي الاعلام مقاولة النا	OBJ
من يمنع الأقباط من التصويت كما يحدث الان لا يحق له بعد ذلك ان يتحدث عن الدين شهوة الاخوان للسلطة قد اعمتهم عن اى اعتبار اخلاقي او ديني	OBJ
الاخوان يستهدفون بالاغتيال ضباط الامن الوطني المسؤولون عن ملفات التنظيم #السادة_المحترمون	OBJ
حافظوا على نظافة ذواتكم #	OBJ
صناع الحياة: مجموعة من الشباب جمعتهم المودة و الحب في الله و حثهم حبهم للخير في محاولة عمل إيجابي لإرضاء ربهم و	NEUTRAL
طلبت العمل في "#ماسبيرو" بدون أجر ولم أتلق ردا التفاصيل على الرابط || …	OBJ
وهذا هو الجزء الثاني من مناقشة كتاب خروج المصريين على الخلفاء والسلاطين لمن لايعرفون شيئا عن كفاح آبائهم وأجدادهم	NEG
بسمة أمل - جزاء مَنّ يسخر من الناس	NEUTRAL
2 تاريخك تحت جزمة الشعب كما شاركتهم اجرامهم وقتلهم للشعب واعتداءهم علي المساجد لا يسعدنا ان نري وجوهكم لأن الواحد منكم له أكثر من وجه	OBJ
#الشروق إحالة أوراق 683 من أنصار الإخوان لفضيلة المفتي في أحدث مركز العدوة بالمنيا: أصدرت محكمة جنايات #مصر	OBJ
انتخابات المجالس البلدية في #قطر الأربعاء	OBJ
يبدأ بعد قليل لقاء د عبد المنعم أبو الفتوح مع الشاعر عبد الرحمن يوسف على قناة في برنامج صفحة الرأي	OBJ
#اكتب_رساله_لشخص_دون_ذكر_اسمه ابي اعرف ذنبي وش سويت عشان تسوي معاي كذا ليه قساوة القلب نسيت شلون كنا واليوم شلون صرنا #ملكه	OBJ
شاهد - آخر كلام: تعديل مشروع قانون عزل الفلول #	NEG
عرض الاسبوع 44 ألف متابع #أذكار_المساء #بصراحه_مليت_من #خد_موقف_من #علمتني_الحياة #الحياة_تحتاج_إلى_شيئين [927665]	OBJ
من أجمل الكتب التي يمكن أن تقرأها لجمال البنا كتابه الإسلام وحرية الفكر وكتاب كلا ثم كلا عن دعاة التقليدتعرف على فكره واختلف معهرحمه الله	OBJ
ورداً على تساؤل فيما خص ترشحه عن" دائرة مصر الجديدة "اجاب دعمرو ان الجامعات هى مساحة للعلم و ليست مساحة للدعاية الانتخابية	NEG
"99: "55: 123 4 #توكل_كرمان هذه عاقه لوالدها ويصفها بقليلة الأدب ""	NEG
كان والدي قد كتب هذه المقالة بعد القبض عليه بيومين الدنيا الجميلة ليس هناك في الدنيا أجمل من أولئك الشبان الذين	OBJ
الحق عائد الشرعية عائدة رئيسنا مرسي عائد بلدنا الحبيب مصر عائد ان شاء الله عائدون عائدون	OBJ
كل سنة وانت طيب يامعلممبروك على كف عفريتأنا شفته قبل رمضان وعجبني جداعقبال اللي جاي أحلى وأحلى بإذن الله	OBJ
أعتذر عن عدم الظهور الليلة لظروف خاصة	OBJ
بمناسبة #رمضانيات 3 ^_^ استنوا ف رمضان فقرات ومفاجأت كتير عالبيدج :) 5 3 :) وحملات و حاجات	NEG
د/ عبد المنعم ابو الفتوح في مؤتمر المنيا : الانفلات الأمنى عملية مصطنعة من خلال بعض القنوات الاعلامية مدفوعة	OBJ
قافل التحرير رغم انه فاضي ومحاصر مسجد القائد إبراهيم ومسجد الإيمان والشوارع اتملت دبابات ومدرعات!!! مش إحنا قلة؟؟ خايف من ا…	OBJ
بقيت كلما أتفرج على حلقة لباسم أفتكر صديقنا الجميل علاء ولي الدين الله يرحمه وأتخيله وهو بيقول للإخوان "يالله ياللي باسم يوسف بيفشخ فيكو"	NEUTRAL
مبدئيا سواءا كنت مواليا لمرسي أو معارضا له، الرئيس الذي ينتظر يوما كاملا حتى يعلن مسئوليته عن دم المصريين ويوقف نزيفه لايستحق منصب الرئيس	OBJ
للأمانة الفيديواللى انتشر مش من أعتصام رابعة الفيديو من سيناء حسب الوصف اللى مع الفيديو ونازل من 3 أسابيع …	NEUTRAL
لن نفرط في #يوسف و #قمر #الاهلي	OBJ
ننتظركم الليلة السابعة مساءً ندوة د علاء الأسواني بمركز شبابيك بالمقطم >> التفاصيل على هذا الرابط >> …	OBJ
الوفد - علقة لـ #محمدفؤاد وتامر بجاتو من بودي جارد في #الجونة -	OBJ
#هى بتقول كلام الولاد و شايفهاا #حريه و #هو فرحان #بالمياصه_الخواتم_السلاسل الصياعة بقت #اسلوب_حياة و الشمال بقى #بنى_ادمين مش #اتجاه	OBJ
#دمياط من جهة الاستاد كام لايك للصورة دي تصوير المبدع | محمد حويلة صوت دمياط	OBJ
رابط تحميل المعصرة عدد اليوم:مايطلبه المواطنون للرئيس الميمون والأبواب الثابتة ورسوم عمرو سليمأتمنى تعجبكم	NEG
#هذة_مصر عز و فخر لهذه الامة	POS
بعد ذهابي للقصر العيني القديم ومعرفة أن حالات الإصابة تقريبا 30، 8 إصابات بأعيرة نارية، عدت لقسم قصر النيل وتقدمت ببلاغ ضد المجلس العسكري	OBJ
#الكويت #السعوديه #البحرين #قطر #ا?مارات #عمان #العراق #مصر #تونس #الجزائر #المغرب #ا?ردن #السودان #لبنان 54	OBJ
مبروك يا كرم، مصر كلها فرحانة بيك " وبعد الليل يجينا النور"	OBJ
مؤتمر حزب العدل لدعم #حمدين_صباحي رئيسا لمصر : حمدين صباحي: مشروعي هو قيام دولة مدنية خالية من الفساد	NEUTRAL
انا استمتعت بأداء تشيلسي أمام اتلتيكو مدريد الكرة التي احبها الكرة عقل مدربين وليس فقط مهارات وسرعات لاعبين #ذا_شامبيو…	OBJ
مصر لن تخضع بأي حال من الأحوال لأي ضغط امريكي طول ما الفريق السيسي عايش !!!!	OBJ
الرسالة رقم 15 من الجزء الاول لكتاب رسائل سجين سياسى الى حبيبته	OBJ
#كائنات_فكاهيه مره جماعة - عارفة نفسها - اهتمت بالسياسة و أهملت #العلم_الشرعي 80 سنه و #فجأة فشلت فيها هيا كمان ، يااااادي …	OBJ
شاهد - منتج فيلم مبارك و العائلة حسين الرزاز في آخر كلام #	POS
#البحوث العلمية عالية التأثير متاحة الآن للمجتمع بأكمله #اصدارات_مدينتك #نيتشر"	OBJ
تحقيقات واحكام كالمطر لمعارضى الانقلاب ولا حس او خبر عن تحقيقات فى مذابح الحرس والمنصة ورمسيس والنهضة ورابعة	OBJ
معني ان يستغيث اهالي دلجا من الارهاب فتستجيب #كلام_و_كلام #يوسف_الحسيني #السادة_المحترمون	OBJ
يلا يا رجالة نشيررررررررررر	OBJ
#السعودية #هاشتاق_فاضى #دوم_فاضي #واحد_فاضي #الرياض 7 #واحد_فاضي #1فاضي #صباح_الخير #صور_كنك_بنت	OBJ
شكرا جزيلا على الترجمة وتحياتي للأستاذة نادين،هو بس في آخر فقرة اللي قايل المقولة شاعر العامية ابن عروس وليس عمرو ابن العاص	NEG
ستصدر حكومة مرسي قانون التظاهر وسيتظاهر الشعب أنه قرا القانون قبل ماينزل يتظاهرالقضاء على التظاهر يكون بالقضاء على أسباب الغضب يامعفنييين	OBJ
السيسي تعرف علي عائلة مبارك مبكرا حتي أن سوزان هي التي زوجته من شقيقة أحد رجال الأعمال ولثقة مبارك في ولائه عينه مديرا لل…	OBJ
على صعيد اخر اليابان كسبت اسبانيا النهاردة الجنسنج بيصنع المعجزات	OBJ
متابعات : صلاح فضل: نظام الإخوان قمع حرية المرأةالوفدوتابع "فضل" خلال كلمته بندوة "ن #الاخوان #يكفي	OBJ
ل لم يصمد عامين وكتبوا بعده وثيقة الحقوق واستفتي عليها وأقرت ب75? من الولايات رجاء التحري لأنك واضح إنك تسمع ولا تقرأ	OBJ
في طريقي إلى مؤتمر بحي عين شمس, الآن أمر على المطرية حيث كان اول مؤتمر انتخابي لى من شهور	OBJ
الندل لما حكم مقالي اليوم في الشروق تحية لكل المعتقلين في شخص الثائر السكندري حسن مصطفىاكتبوا له وادعموه في محبسه	OBJ
من كندا مدينة تورنتو #سوريا_في_القلب __	OBJ
معلومة عدد بطولات الحارس بينتو وهو على دكة احتياط #برشلونة آخر ٥ سنوات اكثر من عدد بطولات #ريال_مدريد آخر ١٧ عام مضى وا…	OBJ
يوسف الحسينى يتابع منذ ايام مايحدث للاقباط فى دلجا ويطالب المسؤولين بالتدخل واليوم سيطرت الشرطه والجيش …	POS
الغرب لم يرحم عندما قدر ولم يخش الله في دماء واعراض الناس ومحاولته الالتفاف حول الثوره محا	OBJ
الانتخابات القادمة ستكون لحظة مهمة في تاريخنا سيعرف ملايين المصريين من يساند الثورة ومن يتآمر عليها اما رضا عام وأما معركة حاسمة	OBJ
ملاحظ إن لوجو رابعة قرب ينقرد	OBJ
#بيقولك_أعرف_بلدك القاهرةلقا، الأديان في مربع واحد هكذا أراد الله مصر واهلهاآمنين باذن الله #اخوان_ابليس	NEG
جائزة ولاد البلد تمنح لأفضل مبادرة حاولت صنع تغيير في حياة الناس باب الترشيح سيغلق يوم 15 ابريل سارعوا بالمشاركة	OBJ
#الوطن| الهدوء يسود ميدان الحصري بـ"#أكتوبر" وتكثيف أمني تحسبا لمظاهرات #الإخوان	OBJ
جرب ولا تخف فمن صنعوا سفينة نوح كانوا هواة اما المحترفين هم من صنعوا سفينة تيتانك #ابراهيم_الفقى	OBJ
للامانة هو كتبها من ساعتين اذن فنظن انها سخرية :)	OBJ
دعبد المنعم ابو الفتوح يتحدث عن ذكرياته لواقعة المشادة الكلامية بينه وبين الرئيس السادات	NEG
قدم حياته لأجل كرامته فصارت ( أم الشهيد ) #الاردن #رائد_زعيتر	OBJ
و هعيش و اموت و افضل عشانة و هو فوق دايما مكانة #الاهلى	OBJ
ألف صورة لألف شهيد من شهداء مجازر الانقلاب الدموي في #رابعة و #النهضة و #رمسيس و #الدقي …	NEG
مخيم الشاطئ للاجئين الفلسطينيين في #غزة و فيه يعيش رئيس الوزراء اسماعيل #هنية	OBJ
قطاع التشييد البريطاني يواصل نموّه - #بالعربي	OBJ
عرض #لماذا_تتواجد_بتويتر #كذب_البنات #سولف_لنا_عن_طفولتك #لو_بس #ماأجملها_من_كلمة #في_العمق #تعليق_الدراسة [123070]	NEG
علاء الأسواني: للأسف المسلمين في كل هذه المعارك خسروا حقهم و ساهموا بأنفسهم في تشويه صورة الاسلام المقال كامل	OBJ
#هل_حياة_سندي_عالمة اي واحد عنده لغه انقليزية يعرف تماما حجمها الطبيعي وحتى انها لم تنشر اي بحث بصفتها باحث رئيسي #ا…	OBJ
كأن في الآية السابقة دليل على أن الأقرب للواقع يكون الأدرى بالمصلحة #بكفي_حصار #اضبطوا_شركاء_المخلوع # #اليمن #قطر #مصر #تونس	POS
عجبى ع بنت لذيذه شقيه من براها لكن حزينه من جواها تبص لوشها تلاقى البدر منور ليلاتى وتبص جواها تلاقى بنى آدم بيموت يوماتى #صلاح_جاهين	OBJ
الأمربالمعروف جماعة مأجورة من نظام مبارك لإسقاط #مرسى باسم يوسف اول اهبل يطلع خرافه ويتجرور	OBJ
مقتل شخص وإصابة 29 على أثر اشتباكات بين الأهالي والإخوان بالأسكندرية #السادة_المحترمون …	OBJ
الوقوف دقيقة حداد على ارواح شهداء احداث سيناء وعلى شهداء ثورة 25 يناير في بداية المؤتمر الجماهيري	NEUTRAL
قانون محاكمة الرئيس لا يزال ساريا حيث أن قانون محاكمة الوزراء الصادر سنة 1958 لم يلغ قانون 1956	OBJ
شاهد - سفير الحضارة المصرية - الرحالة المصري أحمد حجاجوفيتش في السادة المحترمون # #	OBJ
توفي إلي رحمة الله اليوم أخي "محمد وليد الجفالي" من السعودية أشهد الله أن هذا الشاب قبل أن يتوفي بشهرين ترك	OBJ
#اعترافات_الطفولة عمري مالعبت وانا صغيره مع البنات،كنت دايم العب مع صبيان الي بشارعنا كوره وهجوم بعد،وسباق قاري نفر الشارع ونرد صبي مو بنت	OBJ
#مبارك عنده أبناء و #مرسي عنده جماعة الوحيد اللي غلبان في البلد دي هو عدلي منصور تحسه إنه مقطوع من شجرة !	POS
سنة كنا بنضحك فيها علي قنوات الفتنة لكن و انت بتضحك البلد كانت تحت رحمة تحريضهم المهم البلد الحمد لله	OBJ
يا جماعة المشكلة مش فى الفيديو ولا فى الشريط ولا فى المكان إحنا فى حد فينا نيته وحشة :):) #الثورة #فيلم_ثقافى	OBJ
الجميل في المسلسل ان ماحدش فيكو بيحاول يقلد الشخصيات المثلت الفيلم	POS
أؤيدك أستاذ علاء، بيد أني أخشى من طبيعة الضغط الأمريكي أو غيره مما لا يعلن للرأي العام ، وتأخر فض الإعتصام …	OBJ
قطب العربي عضو جماعة الإخوان يصعد المنصة وهتافات من الصحفيين ضده	OBJ
#في_عالم_موازي اني مخلص كل حاجة ليلة الامتحان و براجع او احل	OBJ
إن مثل إنسان بلا هدف، كمثل سفينة بلا دفة، كلاهما سينتهي به الأمر محطما بجانب الصخور #مي_زيادة	OBJ
حتى اللى حكتله عن اللى سابوك و قالك ان معاك مش هسيبك سابك هو كمان #مبقتش_تفرق	NEG
اللقطات التى تنشر من لجنة كتابة الدستور توحى لنا ان مصر دولة بلا دين ولا اخلاق ولا قيم ولا تاريخ ولا رجال	NEG
مساء الفل عليكم يا اسكندرانية معادكم مع نشرة (5) مساءً #2 اسكندرية	OBJ
و هما يقولوا خليهم يتسلوا	OBJ
انتي ممكن متكونيش #حلوه بس #ربنا مديكي #حلاوه #روح زي الاخت #هيفا #وهبي كدا :) =	OBJ
نادى الاسير في #جنين يدعوا الى مساندة الاسرى الإداريين المضربين عن الطعام رفضا لسياسة الاعتقال الادارى الغير مبني …	NEG
للمعلم كتاب موجز وممتع عن التعليم الالكتروني #معرض_الكتاب #معرض_الرياض_للكتاب 2020 …	NEG
مدن (#فلسطينية) #رام_الله #القدس #نابلس #اريحا #قلقيلة #الخيليل #طولكرم #بيت_لحم #طوباس #جنين #بيتونيا #بيرزيت #جباليا #البي…	OBJ
# #هام بالـ #فيديو اعترافات المهندس رياض عيد المُنشقّ عن تنظيم "#الدولة" # #	OBJ
3_ 0 لأ ارجوك خلي دمك خفيف إيه ده؟ فين كتالوج الألشة؟	NEG
ثمه شعله حنين مشتعله في جوفي حرقت كبريائي حتى الرماد ومزجته في كوب زجاجٍ شفاف وسكبته على أزهار الذكرى حتى أرتوت وينعت #اعترافات_ليلية	OBJ
الذين يقتلون ويذبحون ويلقون الشباب من الأدوارالعلياويعذبون ويبترون الأطراف ويرهبون سكان رابعة ويستخدمون الأطفال…	OBJ
اية معنى وجودنا ف صناع الحياة اننا نيتنا اننا نحقق الأية اللى بنقراها كل يوم اياك نعبد واياك نستعين نعبد	OBJ
#رصد | تظاهرات ووقفات احتجاجية منذ صباح اليوم بجامعة #الفيوم نظم طلاب جامعة الفيوم اليوم عدد من الوقفات …	POS
الخرطوش مع مين !!! بتسأل بجد !!	OBJ
#توفيق_عكاشة بيحكي عن هيفا وهبي هههه!دي كلها عمليات تجميل امبارح شفت صورها ع النت قبل التجميل دي تقرف عشان تعرفو احن…	NEUTRAL
صفوت حجازي: و سوف تصبح العريش عاصمة للولايات العربية المتحدةبس نتلايم عليها الاول	NEG
بنحط جزء منها على تويتر لكن نص البيان بيكون على الفيسبوك او على الموقع /2011	POS
الان تبدأ ندوة د عبد المنعم أبو الفتوح في نادي هليوبوليس	OBJ
#حمزة_نمرة انساان :)	POS
ألرحمة !	OBJ
يكتب بدمه حياه تانية لاوطانه #باسم_محسن	OBJ
#عاجل #الرياض #مكة #خواطر #غرد_بصورة #غرد_بصوره #دبي #غرد_بذكر_الله [31474525]	OBJ
#هانزل_8_30علشان مش هاقبل ان ديني يتهان واقف ساكته	OBJ
ده فيديو اوضح للناس وهى بتفتح المدرسة علشان تخرج الامن منها	NEG
دعبد المنعم أبو الفتوح لـ : فضلت خوض الانتخابات كمرشح مستقل لأمثل كافة طوائف الشعب المصرى	NEG
أوراسكوم تشتري مصنع سماد في أيوا بأمريكا بمبلغ 14 مليار دولار	OBJ
طلب الالتحاق بالبرنامج باللغة العربية	OBJ
مصر التي قزمها الاخوان ، يعيدها شعب مصر لمكانتها ، مصر رافعة الديمقراطية في العالم العربي ، ولن تكون بؤرة وهابية	OBJ
النائب العام يأمر بالتحقيق فى اتهام ياسر برهامى بازدراء المسيحية	OBJ
شاهد - آخر كلام: مصر تملأ مصر عام على الثورة #25 #	OBJ
شاهد - تميم البرغوثي ومصطفى سعيد في الذكرى الأولى للثورة فى آخر كلام #	POS
2 إيه يا أبو حميد إنت لسه في باريس؟	OBJ
معنى هام جداً نحتاجه بشدة في هذه الأيام في بلادنا	NEG
ونعلم ان بعض أبائكم قد مات حسرة وهو يشاهد ابتسامة القاتل، نقولها لكم، لن نقبل الا بثورة تعيد لنا كرامتنا وحقكم ويعيش فيها وطننا رافعا للراس	OBJ
شاهد - آخر كلام: لماذا مليونية الجمعة 8 يوليو # والد أحد شهداء	POS
رحم الله السيد منصور حسن ، غفر الله له وألهم أسرته الصبر والسلوان	POS
بسمة أمل - هدية لعودة الحب لحياتنا	POS
#الوطن | رئيس المجلس المصري للشؤون الخارجية يغادر إلى #نيويورك #مصر #اخبار	NEUTRAL
لازم أعترف لما كنت باروح أمن الدولة أسلم تقاريري كنت باقابل في الكافتيريا عصام سلطان وجورج اسحاق وعبحليم قنديل وكان شفيق	OBJ
لو دفعت اسرائيل مليارات الدولارات ليكره المصريون 6 اكتوبر ما تمكنوا من تحقيق ما حققه سيسي	OBJ
وزير الزراعة #الأردنى السابق #يتفقد زراعة #القمح على "#مصاطب" بالشرقية | الزقــازيق	OBJ
شاهد - عدادات للموت محافظ القاهرة في آخر كلام #	OBJ
يا عمر سيبك من كل دة فى حملة منظمة لتشوية ثورة 25 يناير ورموزها أقرأ مقالة مصطفى النجار فى اليوم7النهاردة وشوف …	NEG
تابعوا الدكتور عمرو حمزاوي على قناة الجزيرة مباشر في تمام الحادية عشر والنصف مساء	NEG
الطرق السلميه والمتحضرة هي في ظننا احد سبل النضال السلمي والمشروع للضغط علي الحكومات في المنطقه لتنهج منهج استقلالي	NEG
اليوم محاكمة المتهمين في قتل متظاهري #الاتحادية	OBJ
هو أنا لما حد من أنصار مرسي يقول لي ماحيلتكش غير الكلام المفروض أرد أقول له إيه؟ غير الشتايم طبعا لا أنا أقصد أفهمه إزاي معنى كلمة كاتب؟	OBJ
الانقلاب الذى يسرق الشرعية وينهب شعبه ليس غريبا عليه انه يسرق حقوق البث لمباراة كرة قدم	OBJ
#النصر_الشباب ليه كذا يا عامر	OBJ
#ذات_مومنت لما تكون قاعد في الامتحان ويجي المراقب يقولك #ماتتكتبش_حاجه_علي_ورقه_الاسئله يا اخي اتنيل مش لما اكتب في ورقه الاجابه الاول	OBJ
1-انسحاب الوفد المصري المشارك في مهرجان مالمو السينمائي بالسويد بسبب مظاهرات حاملي شعارات رابعة فضيحة وهدر غير مقبول لأموال …	OBJ
"الثورة وحدهاهي المؤهلة لاستقطاب الموت,#الثورة وحدهاهي التي توجه الموت,وتستخدمه لتشق سبلا للحياة" غسان كنفاني #مقاومة …	OBJ
2011 احترامي ليك دعبدالمنعم من عضو في حملة دالبرادعي	OBJ
الحلقة الاولى الجزء الثاني: "النهضة لا تزال في"	OBJ
بسمة أمل - قل لى من أصحابك أقل لك من أنت	OBJ
ضمن لجنة تمنح جائزة للحكم الرشيد 5 مليون دولار لرئيس أفريقي سابق لم نجد أحدًا! أفريقيا جنوب الصحراء في طريقها إلى الديمقراطية الطريق طويل	OBJ
دماء شبابنا غالية والمستفيد من العنف هم أعداء الثورة أدعو كل الثوار للتمسك بسلمية الثورة والابتعاد عن الاشتباكات أمام الداخلية	OBJ
شاهد - آخر كلام: أسماء محفوظ بعد مثولها أمام النيابة العسكرية # #	OBJ
نفسي أفهم سر العلاقة بين الملحدين أمثالك وبين قدسية الكنائس ،أليس للمساجد قدسية أيضاً	OBJ
قرار إعادة وزارة الإعلام فشل كلوي تام و مهزلة	OBJ
#عاجل #الرياض #مكة #خواطر #غرد_بصورة #غرد_بصوره #دبي #غرد_بذكر_الله [31543451]	OBJ
أمل الجمل: عن "الشتا اللي فات" وشتاءات أخرى مقبلة	NEG
أون تى في تعيش سكرات الموت وهى تتحرك خلف الشرطة والجيش لتصور علي الهواء تمثيليات القبض علي الإرهاب	NEG
الانسحاب من عضوية التأسيسية ومن لجنتها الاستشارية موقف وطني، التأسيسية فاقدة للشرعية الأخلاقية والقانونية والسياسية، ومسودتها للدستور كارثية	OBJ
قصة حدثت لي في مطار القاهرة أثناء عودتي من مكة بعد تصويري لبرنامج "باسمك نحيا" وكان عن أسماء الله الحسني - وكانت	NEG
قد وجب اقالة وزير الداخلية وتطهير جهاز الأمن من كل فلول واتباع النظام	OBJ
الوطن | فى شأن خاص فريدمان بيتنر | عمرو حمزاوي:	OBJ
نرفض التدخل في تشكيل الحكومة الجديدة من أي جهة أو حزب ونرفض أي شكل من أشكال الضغط على قرارت عصام شرف	NEG
48670715 _ أفخر أنني كنت أكتب ضد التطرف أيام كانت قوائم الإغتيالات بجد مش هجص ومع ذلك لم أصب بفوبيا الإخوان	OBJ
_ وتناسوا القرآن"لا يجرمنكم شنآن قوم" و"لاتقعدوا معهم حتى يخوضوا في حديث غيره"وتحولوا لاسلوب واحدة بواحدة وهم من نشروا الفيلم	OBJ
شبكه اخبار #المحله | عاجل | تشديدات امنيه بمحيط مجمع محاكم المحلة الكبرى وجارى المتابعه لمعرفه التفاصيل	OBJ
ما هى "أخْوَنة" الدولة؟ ولماذا نخشاها؟ - زياد بهاء الدين - بوابة الشروق مقالة رائعة جديرة بالتعمق فيها	OBJ
شاركوا مكفوفين #الاسكندرية	OBJ
د أبو الفتوح في العاشرة مساء : لن نقبل مستبدا يحكم مصر	OBJ
1 كما سجلت أكثر من مرة قبل٣٠ يونيو وبعده، مصر وقعت فريسة لفاشية دينية محرضة على العنف ولفاشية قمع وإقصاء وعنف زيفا باسم المصلحة الوطنية	NEUTRAL
اه يا مجلس يابن الحرام قتلوا #الألتراس الأحرار علشان هما من #الثوار يسقط يسقط حكم #العسكر	OBJ
شاهد - باب الخروج: رسالة علي المفعمة ببهجة غير متوقعة في آخر كلام #	OBJ
الوادي| السفير حسام القاويش، المتحدث باسم #مجلس_الوزراء، للإعلامية #جيهان_منصور في برنامج #صباح_التحرير: رئيس	OBJ
المصريون من انصار الشرعية منعوا مراسلي قنوات العار من الدخول بينهم دون أى واقعة اعتداء والقنوات تسعى لافتعال المعارك	OBJ
الإسماعيلية #كفرالدوار #أسوان #قنا #المنيا #سوهاج #بني_سويف #شبين_الكوم #بنها #إدفو #طلخا #كفرالشيخ #عدن …	OBJ
ايوب : عودة #عاشور و #عمرو_جمال ستكون اضاف قوية للفريق قبل لقاء العودة فيما سيكون لغياب #فتحي تأثير كبير علي الفريق #	OBJ
هل تخطط لحياتك؟ هل خططت لرمضان هذا العام ؟ خاطرة جديدة شاركوني آرائكم علي موقع هايد بارك	OBJ
#رواد_الديسكو ضد #رواد_المساجد سيذكر التاريخ أن الرئيس #محمد_مرسي قاد ودعم #رواد_المساجد وأن #العرص قاد ودعم	OBJ
الحمد لله عدت من أسبانيا بعد الانتهاء من تصوير برنامج رمضان القادم "قصة الأندلس" و كلّى حب لأهل المغرب و	OBJ
هاخد كورسات #كورى فالصيف ان شاءالله ^_^	OBJ
عرض الاسبوع 40 ألف متابع #شوارعنا #فن_تتقنه_النساء #ذلك_الشخص #شي_ودك_تجربه #بوح #درر #عجبني #حلو #مكه [2097739]	OBJ
فوز النصر والفتح في الجولة الـ 24 من كأس الأمير فيصل #كرة #السعودية #النصر #نجران #النهضة #نجران	OBJ
مرسي عمل مناورة وللأسف الناس اللى راحوا ساعدوه بحسن نيةمرسي مصر على فرض دستور الاخوان لكنه لايخدع أحدا على مرسي ان يتراجع تماماً او يرحل	OBJ
ملخص الحلقة السابعة من برنامج #قصة_الأندلس لمشاهدة الحلقة اضغط على الرابط التالي: لو	OBJ
أؤيد بقوة دعوة الشعب للتظاهر السلمى الحاشد ضد القمع و الفساد عندما لا نجد اذن صاغية لمطالبنا ما هى البدائل امامنا ؟	OBJ
تفتكروا فيه أمل لسه ولا خلاص انتهينا هو ممكن نقوم ونفوق كلنا من القرف والعفن إلى على عقولنا ونصحى من الغيبوبة ونركز في تحقي…	OBJ
في احد الفنادق بالدقى وقد تم دعوة الصحفيين وسيتم تغطية المؤتمر على الصفحة	OBJ
#خلق_جميل عندما يفضح احد الاصدقاء اسرارك ولا تقوم انت بالمثل	POS
: أنا أنتظرك لأنني لا أجد شيئاً آخر يُسليني في غيابگ عنّي ! #اعترافات_ليلية"	NEG
كتبت هذا المقال منذ سنة ولازال صالحا للنشرأتمنى أن يساعدك على فهم تقلبات الخلق أيام الثوراتنهاركم سعيد	OBJ
ياسر أبو عمّار في #سياسة_في_دين :علي الجزيره غيّرت موقفي من حزب #النور بسبب مواقفه المخزية مع الرّئيس #محمد_مرسي	NEUTRAL
#تونس | رئيس الحكومة التونسية يبدأ اليوم زيارة إلى #فرنسا و #الاقتصاد و #الأمن يتصدران المباحثات	OBJ
د نادية العوضي مثال الابنة و الأخت و الأم المصرية فقدت اليوم والدها العزيز إنا لله و إنا إليه راجعون	OBJ
_ لا أتحدث عن #تحرش، ماعنيته النظرة الدونية لهن كبدايات الممرضات	OBJ
القبض على محمد بديع المرشد العام للإخوان #السادة_المحترمون	OBJ
تحذيرات قوات الأمن لسكان رابعة والمتظاهرين قبل فض الاعتصام #السادة_المحترمون	NEG
الملك عبدالله: اسرائيل وايران لايستحقان التواجد #السعودية # #الشرقية #8 #جدة #بريدة # #بريدة #الدمام	OBJ
الشعب يحب الرقاصات لأنهم أسعدونا و متعونا أكيد أمك كانت مثاليــة	OBJ
توكل 29 و30 يونيو قبل أن يكلفها التنظيم الدولي بتغيير الخطاب لتشكيل ثنائي إنقاذ مع تتح لإهانة الثورة …	OBJ
واحد صاحبي من حزب الكنبة سألته نازل يوم30 ؟ قاللى : طبعا أنا و الكنبة كمان !!	OBJ
كذب البلتاجي وجماعة الإخوان #يوسف_الحسيني #السادة_المحترمون	OBJ
_ بارك الله لكما وبارك عليكما وجمع بينكما فى خير زيجة موفقه ودعواتى للاسرة بالخير والسعادة	OBJ
#تحيا_مصر☆ #تحيا_مصر☆ #تحيا_مصر☆ #تحيا_مصر☆ #تحيا_مصر☆ #تحيا_مصر☆ #تحيا_مصر☆ #تحيا_مصر☆ #سأنتخب_السيسي☆ …	OBJ
الجامعة هنا في مصر فصلته عشان ماراقبش على امتحانات قسم حشراتوالجيش طلعه غير لائق ذهنيا عشان عنده تهتهه بسيطةالان هو من افضل مهندسين ناسا	OBJ
شاهد - آخر كلام: أزمة التأسيسية قنبلة في الطريق #	OBJ
الإخوان: الصندوق جاء بهم والصندوق كفيل بأن يأتي بغيرهم لندافع عن الديمقراطية وحرية اختيار الناس لمن يحكمهم ونقدم للشعب بدائل ليفاضل بينها	OBJ
: كاتب فى جريدة القدس يفترض أنه ناصري و مش إخوانى ؟ ؟ ؟ ؟ سليم عزوز	NEG
نتهلل فرحا بتفوق طرقنا ع #أمريكا و #اليابان ونسينا أن سكان هاتين الدولتين لا يحتاجون غالبا للسفر بالسيارة أصلا فعلى ماذا تفوقنا؟	OBJ
البرادعي العميل وحمدين وجايبين جبنة نستو يا معفنين؟؟	OBJ
لابد من إقالة وزير الداخلية ومدير أمن بورسعيد ومحافظها فورا أرسلت للدكتور الكتاتني مطالبا بجلسة استثنائية غدا لمجلس الشعب	NEG
البيان الصحفي ليوم الاحد 4 ديسمبر 2011 فوز عمرو حمزاوى على مقعد الفئات بدائرة مصر الجديدة بنسبة -% 53,75	OBJ
#ﻛﺎﻓﻴﻪ_ﺗﻮﻳﺘﺮ_ﻓﻲ_ﻣﺼﺮ حضرتك مفيش فكة تاخد بالباقي ريتويتس	NEG
#الماده_الاولى مكونة من 3 صفحات و مدتها ساعتين	OBJ
#قمة_الكوسة في البلد دي #إلهام_شاهين تتكلم في الدين و #سما_المصري يحبسوها #الحرية_للمناضلة_سما_المصري :)	OBJ
و حاجة كمان بس اديني فرصة	OBJ
مصر تقدم للعالم كل جديد أول دولة فى العالم تصنع الارهاب لتحاربه ولا مانع من اشعال فتنة طائفية لأهداف سياسية	OBJ
من يوميات أخ: اللي يتفق معايا في الرأي حيادي ومنصف وفي قلبه خير كبير هو لايعلمهلما يختلف معايا يبقى نخبة متعفنة مأجورةهما قالوا لي كده	OBJ
د أحمد البرعي وزير التضامن الاجتماعي ضيف #يوسف_الحسيني في #السادة_المحترمون	OBJ
#نبض_نيوز اا #جمعة_الغضب اا بالفيديو موقع أمريكي يرصد مذبحة رمسيس بجمعة الغضب حجارة معارضي الانقلاب في مواجهة …	NEG
محتاجين دعمكم للمركز الطبي الخيري ولو بنشر تويت بالموقع 01201968	OBJ
منى سيف وزوجة دومة ووالدة علاء عبد الفتاح يفترشن الأرض أمام الاتحادية #منى_سيف #احمد_دومة #علاء_عبد_الفتاح	OBJ
برحيل صالح تضع ثورة اليمن أقدامها على أول طريق النصر،نثق فى قدرة شعبنا اليمنى على توحيد الصف لاستكمال أهداف الثورة،مبروك لليمن وعقبال سوريا	POS
حكمة الأسبوع: لكي يصدقك الناس عندما تشكو من إرث الإخفاقات الهائلة التي تركها لك النظام السابق لا ترث عن نفس النظام سياساته الفاشلة	NEG
لو التحرش مرتبط بالعري يعني مبني على شهوة الراجل، على كدة الاوربين باردين اوي لان العري في كل حتة و ماحدش	OBJ
رئيسة البرازيل تؤكد دعوتها للرئيس مرسي لحضور نهائيات كأس العالم فى البرازيل صيف 2014 هم يعرفون عظمة شعب مصر	OBJ
القرآن الكريم مُعَّلق في بيوتنا ولكن لم نشعر أننا هجرناه كما شعرنا أن #الواتساب_معلق ! آخر حالة ظهور للمصحف عند البعض"ر…	NEUTRAL
#شنطة_سيلين_٢٠١٤ #سيلين #شامواه السعر٢٠٠﷼ #هاي_كوالتي عرض خاص لمدة أسبوع #عروضات_خاصه #تخفيضات #الواتس_اب 0506968396	OBJ
اكثر من مليونى شاب شجاع بالجامعات هم العمود الفقرى للمصريين الرافضين للانقلاب	OBJ
: نحن الان امام انتهاكات حقوق انسان ودولة يهدد استقرارها والمجلس اصبح امام ازمة شرعية	OBJ
نتمنى التوفيق لأخواتنا المسيحيين فى إختيار رئيس للكنيسة المصرية هذه المؤسسة الوطنية التى يعتز بها كل مصري	OBJ
يحسب للرئيس مبارك انه حكم مصر وهى تتحدث عن نفسها وبعد ربع قرن من الحكم جعلها تتحدث مع نفسها #بلال_فضل	NEUTRAL
مترو موسكو، أو قصر تحت الأرض كما يوصف أحيانًا بسبب فخامة تصميمه الكلاسيكي،، #عمارة #روسيا #تصميم #تصميم_داخلي #مترو …	NEG
ماكنتش متخيل إن إعادة نشر تعريفات الجاموس المحيط على تويتر بيخليها تنتشر كده مع إني كاتبها من 2005 ومابعدهكل يوم هانزل شوية كده بإذن الله	NEG
تنمية محور قناة السويس يعد مشروعا قوميا #السادة_المحترمون	POS
1 تم الاستماع إلى أقوالي اليوم في البلاغ المقدم من أحد المحامين، وليس من قضاة، ضدي في ١٧ يونيو ٢٠١٣ بزعم أن إحدى التغريدات بها إهانة للقضاء	NEG
بيع متابعين #السعودية #الكويت #برشلونة #النصر #الهلال #الإتحاد #الإمارات #الرياض #الدمام #بوح #عمان #دبي #جدة 051	NEG
يوسف الحسيني بالفيديو يفضح كذب قناة #الجزيرة ويكشف تمثيل #الاخوان دور الميت	OBJ
": #السعاده "	OBJ
المصري اليوم| السفير حسام القاويش، المتحدث باسم #مجلس_الوزراء، للإعلامية #جيهان_منصور في برنامج #صباح_التحرير:	POS
الإحباط طاقة جبارة يمكن أن تكون سلبية و يمكن أن تكون إيجابية	OBJ
#تخفيضات #الأحساء #ريتويت #الرياض #واحد_فاضي #الهلال #السعودية #النصر #النصر_الهلال #غرد_بصوره #الرياض [1615445]	OBJ
الندوة الأسبوعية للدكتور علاء الأسواني الخميس القادم بمركز إعداد القادة بالعجوزة >> التفاصيل على هذا الرابط:	OBJ
الصحافة العالمية ومحاكمة مرسي لا روبوبليكا الايطالية: مع بدء محاكمة الرئيس السابق مرسى يطالب بوضع حد للمهزلة	OBJ
بعد عزل الرئيس السابق #محمد_مرسي، تولت سلطة جديدة في #مصر، فهل تداركت الأخطاء التي وقع فيها جماعة	OBJ
مصر الثورة لن تجدي معها لغة التهديد #السادة_المحترمون	OBJ
موقف نقابة الصحفيين من تغيير القيادات الصحفيةأ حنان فكري #السادة_المحترمون …	OBJ
عليك ان تثق دائما ان هناك امل متقلقش بكره احسن ربنا موجود #يوسف_الحسيني	OBJ
للاسف كانت زيارة سريعة ولنا زيارة قريبة ان شاء الله	OBJ
لمن يتحدثون عن ضرورة المشاركة في الحوار مع الرئيس وأن التعاطف الشعبي مع المعارضة سيتراجع إن لم تشارك في الحوار وأن التاريخ لن يرحمها	OBJ
ما الذي يجب أن تعرفه كل #امرأة عن سرطان الثدي؟ #سرطان_الثدي	OBJ
#رابعة كانت فعلا هي #الثورة بعد ما نضفت من #النجاسة و #الوساخة (الكتير) ، اللى ملت #ميدان_التحرير #حقيقة	OBJ
السادة الأفاضل بجريدة المصري اليوم عن الخبر المنشور حول إلغاء ندوة لي بنادي الشمس للدعاية الانتخابية الخبر غير صحيح	POS
من ذكريات #الأقصر متحف التحنيط	POS
#في_حاجة_صح ان الجيش المصرى قوى ومتماسك	NEG
#متصدر_لاتكلمني, #النصر_الشباب, #الهلال, #اكشن_يا_دوري شجع ناديك بدون تعصب مع برنامج الايفون الرائع 507	OBJ
الله يفتح عليك ويقدرنى اكون عند حسن ظنك ووصفك	OBJ
تولِّى #السيسي رئاسة مصر معناه انتهاء الحكم العسكري	OBJ
": ما هو يا نبعت #مبارك إلمنيا يتحاكم يا ننتدب قاضي إلمنيا ينزل القاهره يبوسه من بُقُه و يرجع" ننتبه يبوس و يحضن كمان	OBJ
الذين يدافعون عن مرشحهم المفضل بالشتائم يشبهون الدبة التى قتلت صاحبها وهي تهش الذبابة بحجر طرحت أسئلة موضوعية عن ابو الفتوح الذي احترمه	OBJ
مواجهة التطرف والعنف من قبل مجموعات من مشوهي العقول والضمائر يرفعون زيفا شعارات دينية، في الجامعة وخارجها، ضرورة لن يرهب من يدافع عن الحق!	OBJ
من الذي زار مرسي في مخبئه السري؟! دعلاء الأسواني يكتب مقاله بعنوان : " كيف للرئيس أن ينام ؟! " على هذا الرابط >>	POS
طب الواحد يصدق أخبار مكتوبة فين بالضبط؟ ولا ما يصدقش حاجة خالص؟	OBJ
دباسم يوسف عمل برنامج البرنامج و #فسسسسسس	NEG
لا للصدام بين الشعب والجيش ولا لاستخدام العنف ضد المتظاهرين سلميا وحدة الصف الآن هى أهم ضمانة لاستكمال أهداف الثورة ومسيرتها	NEG
ناس زى منى ولميس ومنال ودرية لما الدنيا تضلم ويحطوا راسهم على المخدة بيقولوا لنفسهم ايه	OBJ
الشعوب لا تنهض بالكلام والظواهر الصوتية لم ولن تحدث فارقا يذكر عبر التاريخ!	NEG
سي بي سي:#إبراهيم_محلب يشارك باحتفالية تنزانيا اليوم بمناسبة العيد الخمسين للوحدةنيابة عن الرئيس #عدلي_منصور #	NEUTRAL
عمر الغامدي : 18 بطوله مع #الهلال و 3 بطولات مع #الشباب 21 بطولة #اسطورة ♡	OBJ
واقعين من ال١٣ اي اموال وخلاص	OBJ
كتاب الظلام :) "	OBJ
الان مي وهبة عضو المكتب السياسي لتمرد ومحمدعبدالعزيز عضو لجنةالخمسين ضيفا #يوسف_الحسيني في #السادة_المحترمون …	OBJ
وحدوا الله يا جماعة وبلاش إشاعات عن مفاجآت عشان مش عايزين إحباطات كل الحكاية ملف معقد هنحاول نفهمه مع بعض :)	POS
استكر الإعلامى يوسف الحسينى إهانة الشيخ محمود #يوسف…	OBJ
#هننضف_لو بطلنا تحرش	NEG
_ مبارك سحبه مرتين بالفعل راجع معلوماتك	NEG
فيليب سكولاري : اتمنى خروج #تشيلسي امام اتليتكو مدريد غداً لاجل إراحة البرازيليين المتواجدين بـ تشيلسي لويز - اوسكار - ويليان قبل المونديال	OBJ
حجم المسؤولية على قنوات اون تي في سيزداد أكثر مع المرحلة المقبلة #السادة_المحترمون	OBJ
ردك ممتاز ولديك استعداد طيب للكتابة تحياتي	OBJ
عرض الاسبوع 36 ألف متابع #وش_أكثر_شي_يسهرك #صيام_الإثنين #خد_موقف_من #صلاة_الوتر #فى_تويتر_تلاقى #الدمام [932279]	OBJ
تقديرات مرسي في لانتخابات ( شاطر- شاطر جداً - بديع )	OBJ
من قال محصنه أو منيعه فقط من يحق له الطعن وليس كل من هب ودب لاعهدمبارك لامرسي ح يعود أبدا #الاخوان_جماعة_ارهابية	OBJ
": "العامة للسلع التموينية": شراء 180 ألف طن قمح من روسيا! يجب عدم التعامل مع روسيا إلى حين وقف دعمها لنظام السفاح الأسد"	OBJ
عن الحب والصبر - رسالة للشباب - بسمة أمل	OBJ
د أبو الفتوح : أثناء زيارته لكنيسة السيدة العذراء بالأقصر	OBJ
رَبَّنَا إِنَّنَا آمَنَّا فَاغْفِرْ لَنَا ذُنُوبَنَا وَقِنَا عَذَابَ النَّارِ ♡ #دعاء #دعائي #غرد_بذكر_الله #أدعية #يارب	OBJ
ويرجعو يقولولك عايز تسيب مصر لية؟ #سانت_كاترين	OBJ
تفعيل الرخصة الرابعة خلال 3 أشهر #مصر #اخبار #	OBJ
#يوسف_الحسيني لحزب النورخليكم في الدعوة وابعدوا عن السياسة بتلوثكموبتلعبوها غلط كمان! #السادة_المحترمون …	OBJ
_ #صلاة_الفجر وبطل شغل كبس عليا النوم فجأ هيا قوم الله يجزاك خير انت وهو مانبغى حركات ايام #المدارس في #الصباح هههههههههه	OBJ
عاجل القبض على محمد بديع مرشد الإخوان المسلمين فى شقة سكنية ب " رابعة العدوية "	NEG
انها ليست مجرد قصة نحكيها انها دروس نتعلمها من ماضينا المشرق لنصلح بها حاضرنا و مستقبلنا إنها #قصة_الأندلس	OBJ
#الشروق آلاف العراقيين في الخارج يقترعون ضمن الانتخابات التشريعية لبلادهم: بدأ آلاف العراقيين المقيمين #مصر	OBJ
عقبالنا :)))	POS
رسالة هامة للآباء - بسمة أمل	OBJ
عرض الاسبوع 36 ألف متابع #وش_أكثر_شي_يسهرك #صيام_الإثنين #خد_موقف_من #صلاة_الوتر #فى_تويتر_تلاقى #الدمام [860889]	OBJ
د عبد المنعم أبو الفتوح : في برنامجي الانتخابي جانب يركز على تغير ثقافتنا عن التعليم الفنى والمهنى والاهتمام بدعمهما	OBJ
ميغركيش العدد والله #انا اكتر انا اللى مش #اخوان وانا اللى مش #عسكر	OBJ
#أحمد_موسى معروف بقربه من #أمن_الدولة | أخبار الموجز …	NEUTRAL
الدين و السياسة هو عنوان حوار اليوم مع د عمرو خالد و الإعلامى محمود سعد فى برنامج "أخر النهار" انتظرونا بعد قليل	OBJ
لما تتأسف وتعترف بغلطك دا شيء إسمو #خلق_جميل	NEG
الرؤية والخبرة والكفاءة و المصداقية سلع نادرة في الإدارة الحالية للبلاد ماذا حدث لمصر الثورة ؟	OBJ
اختيار محمود غزلان أمينا عاما لتنظيم الاخوان المسلمين #السادة_المحترمون	OBJ
جبهة #ثوار تنظم مسيرة من أجل "إسقاط قانون التظاهر والحرية للمعتقلين" | تلفزيون الاشتراكي #	OBJ
بعد قليل ننشر لكم فيديو من ندوة دعلاء الأسواني من ساقية الصاوي بتاريخ 14-6-2012 ويوضح موقف دالأسواني من انتخابات الإعادة الأدمن	NEG
الاخوان وصلوا لمرحلة فبركة ندوة لعالم اللغويات اليساري نعوم شومسكي بيقول فيها أن دبي بتضرب في مرسي علشان تطوير قناة السوي	OBJ
قال رسول الله صلى الله عليه وسلم: "إن للصائم عند فطره، دعوة لا ترد" بماذا دعوتم الله قبل الإفطار يا شباب؟ #دعاء_الإفطار	OBJ
انا اللي بالأمر المحال اغتوي شوفت القمر نطيت لفوق في الهوي طولته ما طولتوش ايه انا يهمني و ليه ما دام بالنشوة قلبي ارتوي #صلاح_جاهين	OBJ
لو اصبح كل الناس ثوريين، ولكن لم يوجد اي تحرك اجتماعي، تأكدوا لن يتغير شيء من يريد التغيير، يجب ان يتحرك على ارض الواقع #ا…	OBJ
الاحد القادم دورة مجانية - طريقك الآمن للاختبارات #الشرقية #السعودية _	OBJ
الواعظ المحتال!	OBJ
ضحكت على الفيديوهات دي و اكتئبت بعديها في النهاية هؤلاء يشوهون دين ربنا ماتستغربوش من كتر اعداد المجاهرين بالردة قريبا	OBJ
شاهد - آخر كلام: الاعتداء على أحمد أبو بركة المستشار القانوني لحزب الحربة والعدالة #	OBJ
أتضامن مع المستشارين حسن النجار وعلاء شوقى وأشرف ندا معا من أجل استقلال القضاء ومحاكمة المدنيين أمام قاضيهم الطبيعى لا للمحاكمات العسكرية	OBJ
إيه ده #طارق_سويدان بيتكلم زى #البرادعى العلمانى الكافر الزنديق أولا يتدبر أولى الألباب !!	OBJ
#الحقيقة_مباشر_مصر|#انقلاب_3يوليو صرح وكيل وزارة الاوقاف لشئون المساجد حتى لو حمل ياسر برهامى شهادات أزهريه فلن	OBJ
المومني نقيبا للصحفيين #وقفة_الاخبارية | #نقابة_الصحفيين | #المومني انتخبت الهيئة العامة لنقابة الصحفيين في	OBJ
" الشباب قاد ثورة #مصر لكن الحرس القديم مازال يحكم " #بوابة_القاهرة #السيسي #ثورة_25_يناير …	OBJ
#تويت_برسمة_انت_راسمها #كلنا_رسامين #فن #رسم	OBJ
وزير الداخلية اللي قاعد يتكلم قدامنا لا يستطيع أن يعطي أمرا لأصغر ظابط دون الرجوع إلي عضو المجلس العسكري المسئول عن وزراة الداخلية	OBJ
لا شك ان فهمى هويدى أخطأ ومن الاخطاء ما يصل الى مرتبة الكوارث لكنه يمتلك ارثا طيبا يسمح لنا بعتابه دون عقابه	NEG
محمد رمضان أحد ضحايا #سانت_كاترين "في أمل متقلقيش" #مصر	OBJ
لاتنسون اخوانكم المجاهدين في #سوريا من دعواتكم الصادقة	OBJ
: الضرورات تبيح الاستعباط - باسم يوسف - بوابة الشروق #مصر "	OBJ
باسم يوسف ربما أكون من القلائل الذين لم يكتبوا عن باسم يوسف ، أيام صولاته وجولاته عن الرئيس مرسى ببرنامجه	OBJ
الشورى : الحكومة مازالت توعدنا و #إضراب_الأطباء مستمر #مصر	OBJ
اول فيديو لبديع لحظة القبض عليه على اون تى فى	OBJ
#إيران: أول اختبار لـ #روحاني بعد رفع سعر #البنزين	NEG
بعد الانفاق في معسكر اعداد وملابس وكتيب المشاركة في العاب الفرانكفون وقبل 24 ساعة من السفر الغى طاهر ابو زيد	NEG
جمعة مباركة تحرير وتطهير مصر واجب اخلص النية وجدد النية لله وحده انزل احشد اهتف سلمية سلمية سلمية	OBJ
اكتب اسم بلدك وأرسل رسالة لأحرار سوريا #سوريا_فى_القلب	OBJ
#حركة_كايدينهم صباحى للوطن: "السيسى" ليس مجرماً هو قائد جيش عظيم انحاز لشعبه فكيف أحاكمه؟ ما ترسالك على بر يا حمضين قاتل ولا مقاتل ؟ #هع	OBJ
#حركة_كايدينهم #تحيا_مصر #السيسي_رئيسي_2014 #باسم_طلع_حرامي #سأنتخب_السيسي انصار الارهابيه يشتبكون مع الاهالي بالزرقا	OBJ
بس عمرهم ما فضلوا يشكروا فيهم و لحسوا الكلام اللي قالوه عليهم	OBJ
_ هل من الاسلام لستخدام المساجد لاطلاق النار علي الاخر هل هذه هي وظيفة المسجد في الاسلام؟؟؟	OBJ
احنا قضينا عشر ايام فقط في تونس، وماحدش فينا بيتكلم فرنساوي ولا حاجة وفهمنا اكتر من تسعين في المية من كلامهمالكسل حجة من لا يريد التعلم	OBJ
الوفد - شاهد - استمرار هدم العمارات المخالفة خلف #المحكمة_الدستورية ب #المعادى	OBJ
كله بتاع مصلحته ، #عسكر #اخوان ، والشعب عليه يطبل للي يحكمه!!	OBJ
دعلاء الأسواني: هل حدث من قبل في نظام ديمقراطي ان سحب شعب الثقة من رئيسه المنتخب ؟! >> …	NEG
طيب إرسوا لكو على بر هو المواطن قلع نفسه ولا المتظاهرين قلعوه ولا قطاع الأمن المركزي عراه وقطاع حقوق الإنسان لبسهعايزين وساخة ليها منطق	OBJ
سيذكر تاريخ القضاء فى مصر كل قاضى انحاز للعدالة و لم ينحاز لحزب أو جماعة أو نظام حكم	OBJ
__7 القدر هو ان تبقى #مصر اما الأمل فهو في الحراك الوطني على ان يكون حكيما مستفيدا من تراكم الخبرة و ليس الاعتماد على اسماء	OBJ
حوار مفتوح ومناقشة للأحوال السياسية الراهنة في ندوة دعلاء الأسواني الليلة الخميس -7مساء بأتيليه الأسكندرية, التفاصيل>	OBJ
في يومٍ من الأيام قرر جميع أهل القرية أن يصلوا صلاة الاستسقاء تجمعوا جميعهم للصلاة لكن أحدهم كان يحمل معه	OBJ
تأجيل #محاكمة_مرسى وقيادات #الإخوان بقضية "التخابر" لـ6 مايو	OBJ
#الداخلية_بلطجية #تعذيب المهندسة داليا رضوان تم الاعتداء عليها بالضرب الخميس الماضي في أحد الكمائن بالعجمي	OBJ
انتظروا #قصة_الأندلس في رمضان	OBJ
المعتصمون داخل مسجد الفتح يستخدمون طفايات الحريق ويتهمون الجيش بإطلاق قنابل الغاز عليهم #السادة_المحترمون …	NEUTRAL
الاستهانة بحياة الناس جريمة انسانية تستوجب العقاب السريع نطالب بتحقيق فوري في احداث مقتل 37 معتقل سياسى مصري اثناء ترحيلهم الي سجن ابو زعبل	OBJ
#عكنن_علي_اسرائيل تاريخ لا #ينسي عبور #خط بارليف #أكتوبر _١٩٧٣	OBJ
يا جماعة البرادعي جاب سيرتي في تويتة لولولولولولولولي شكرا للنائب العام اللي اتاح لنا الفرصة دي	OBJ
أنا مش فاهم إزاي حد متخيل في حل للدم اللي في الشوارع من غير إتفاق على حكومة إنقاذ وطني وإدراك أن ماحدش هيقدر يصلح الخرابة دي لوحده	OBJ
يا دكتور انت بالريتويتات ال بتعملها دي بتكشف العنصرية المتأصلة داخل الشعب المصري	OBJ
#جمال #خيال #حقيقه #جميل #درر #حكم #أعجبني #حكمه #بقلمي #شوق #بوح #شعر #قصيد #رتويت خمس الاف متابع بـ 200 ريال 458	NEG
من كتاب خواطر قرآنيه للدكتور عمرو خالد سورة البقرة : لماذا سميت السورة بالبقرة؟ قد يجيب البعض بأنها سميت	OBJ
الرقابة المجتمعية أكثر فعالية من الرقابة الإدارية وهي وسيلة	OBJ
دعمرو حمزاوي علي قناة أون تي في:- مجلس الشعب هو الجهة الوحيدة التي تملك شرعية صندوق الانتخابات	OBJ
علوم الإمارات - | العثور على 3 خادمات هاربات عبر حساباتهن في فيس بوك #الإمارات #	NEUTRAL
" #حقيقة #ذكرى #جسر_عبور # -	OBJ
1 طرحت ضرورة الانتخابات الرئاسية المبكرة منذ أشهر ما أن تكررت انتهاكات حقوق الإنسان وسقطت الشرعية الأخلاقية، تمتنع المزايدة على الموقف هنا	OBJ
تانى تقنين للبلطجية مجلس الوزراء يقرر وضع حد أدنى وحد أقصي للمكافأت وانشاء صندوق اجتماعى ومعاشات وتأمين صحى	OBJ
إسرائيل تحيي ذكرى #المحرقة (#الهولوكوست) بالعبري: #שואה شوأة #	OBJ
الوقت من دونگ تباطئ ثوانيہ گن الدقايق ماتداني #بعضها ♡ #م	OBJ
شاهد - آخر كلام: عصيان بورسعيد هل يصمد؟ هل ينتصر؟ #	OBJ
خد اللقطة كدة #السادة_المحترمون	OBJ
#منى_سيف : لا للمحاكمات العسكرية للجواسيس اللى بيتعاونوا مع اسرائيل ! #تويت_كأنك_ناشط_ايام_حرب_اكتوبر	NEG
نسعى في الحملة - وبعدها اذا وفقنا - ان نجمع كافة الوقى والتيارات من اجل العمل على نهضة بلدنا	OBJ
اعظم نادى فى الكون #الاهلى	NEG
وزير التموين يقرر توصيل إسطوانات البوتاجاز للمنازل في 48 ساعة #السادة_المحترمون …	OBJ
# الاعلامي : محمود سعد : في هذه الظروف نحن نحتاج لان نسمع صوت الحكمة لنفهم ما يدور حولنا , و د/	OBJ
تدوينة: شياطين النظام السابق وملائكة النظام الجديد	OBJ
الم يكن من الأحسن ان تؤجل الانتخابات أسبوعين تضامنا مع شهداؤنا الجدد و حتى يتوفر الأمن و الهدؤ لكى نذهب جميعا لنحتفل باول انتخابات حرة؟	OBJ
الدكتور عبد المنعم أبو الفتوح على الحياة2:برنامجي الإنتخابي لمصر وليس لفصيل بعينه,لأني مرشح لكل المصريين	OBJ
#بصـراحـه مفيش حد يستاهل غير اهلك	OBJ
لو منصب المرشد مستوياته أعلى من الرئيس يبقى يتهتفله كام يسقط يسقط؟	OBJ
#الميدان:القضاء الانقلابي يحظر 6 ابريل ويتحفظ على مقراتها	OBJ
مين الآي فتى بكده؟ أومال اللغة القبطية دي إيه واللغة النوبية إيه؟	OBJ
وسيتذرع الغاصبون بكم لمناهضتكم وإطفاء نور دعوتكم وسيستعينون في ذالك بالحكومات الضعيفة والأخلاق الضعيفة 5⃣ #حسن_البنا	OBJ
اللي بيطالب ان الازهر هو اللي يفسر مبادئ الشريعة في الدستور حيكون ده رآيك لما قيادته تتغير؟بصوا على الهجمات المسعورة ضد المفتي وشيخ الازهر	OBJ
احمد موسي: باسم يوسف صرصار ينداس بالجزم, أول مرة يقول حاجة صح لغة الصراصير معروفة بين الحشرات ومذاق الجزم له عشاقه فردتين لبيادة	OBJ
محمد بديع: أطلب من أبي محمد حسني مبارك أن يرفع الظلم على المسجونين #مصر #فلسطين #تونس #قطر #سوريا #الإمارات #لبنان	NEG
#الشروق | #المعصرة | قلمين يكتبها #بلال_فضل ويرسمها #عمرو_سليم	OBJ
عرض الاسبوع 44 ألف متابع #أذكار_المساء #بصراحه_مليت_من #خد_موقف_من #علمتني_الحياة #الحياة_تحتاج_إلى_شيئين [945757]	OBJ
انا اسف اني اقول ان مش وقته خالص سؤال :حتعمل ايه بعد ما مرسي يمشي فعلا؟ افيهات و خطابات اهم من البلد؟ يتحرق البرنامج يا عم	OBJ
هي عدت على الشروقكان لازم يقولوا إن البلاغ هو اللي قايل كده لإن المحضر لما هينتقل عشان يعلن السفارة اليهودية هيتعب	OBJ
مطلعتش أنا زي ماكنتي بتقولي اول و اخر حبيب لحقتي عرفتي و دوبتي و عشيقتي لحقتي نسيتي و هجرتي و بعتي #عزيز_الشافعي	POS
ندوة دعلاء الأسواني الليلة السابعة مساءً بالمقطم التفاصيل >>	NEG
كذب الاهرام نفس صورة الاسلحة المضبوطة في عمان	OBJ
… #رتويت_عاجل تم قفل قناة دريم والسبب	OBJ
الحمد لله الحمد لله الحمد لله 3 3 3 #مصطفى_حسني	OBJ
أتابع ما يحدث اليوم وسأعلق عليه خلال الساعات القادمة، وحزب مصر الحرية يصدر بيانا الآن	NEG
كان رسول الله - صلى الله عليه وسلم - أخفَّ الناس صلاةً على النَّاس، وأطول الناس صلاةً لنفسه #نشر_سيرته #	OBJ
لا افهم سبب الاصرار على قانون الانتخابات الذي رفضت كل القوى الوطنية والسياسية د عبد المنعم أبو الفتوح في ندوة بنادي هليوبوليس	NEG
احمه ،، محمه ،، محموه :) :) #مصريين بينادوا علي بعض : :) 7	OBJ
الرد على قانون قتل الحرية: إدانة محلية ودولية، تأييد شعبي واسع للتغيير - بدأنا المشوار	OBJ
عرض الاسبوع 36 ألف متابع #وش_أكثر_شي_يسهرك #صيام_الإثنين #خد_موقف_من #صلاة_الوتر #فى_تويتر_تلاقى #الدمام [931841]	OBJ
بالصور السيسي يستقبل وفدًا من المستثمرين ورجال الأعمال بقطاع السياحة #مصر #ميدان_التحرير	OBJ
#الملعب | إيهاب عبدالله رئيس نادي #دمنهور:فريق الكرة بالنادي يعتمد على مجموعة من اللاعبين صغار السن ونأمل تحقيق نتائج طيبة الفترة المفبلة	NEG
اتمني لكل المدن التي تنتخب اﻵن ان تختار الرجل المناسب #ليبيا بنغازي #القبة #المرج	OBJ
رجاء النشر سينمائيون ضد المحاكمات العسكرية للمدنين: خالد يوسف لا يمثلنا	OBJ
! #مثقفون_فضحهم_الربيع_العربي #واحد_فاضي #الام #عيد_الأم #يوم_الأم #يومك_يا_أمي #عيد_الأم2014 #عيد_م…	OBJ
#الحقيقة_مباشر_مصر|#انقلاب_3يوليو حلقت 3 مروحيات تابعة للجيش فوق قرية #الميمون التابعة لمركز الواسطي ببني سويف،	OBJ
#اول_ما_جيت_تويتر عملت فولو لوائل غنيم حبيبي	OBJ
الاهرام رجع زى أيام هيكل البلد زى الفل بس تعبانة شوية وقواتنا تقترب من تل ابيب بس اسرائيل ضربت كل مطارتنا	POS
#معرض_الكتاب شيء غريب !!! ماهذا ؟ للأسف #حقيقة	OBJ
ليس من الاسلام القتل والحرق واثارة الفزع والتعدي …	NEG
١ يحرص عصابة الانقلاب علي تحسين صورة مصر الممزقة والنجسة في العالم عن طريق كلاب البيادة من مذيعين وضيوف في	OBJ
عربستان كيف اختفت كدولة ؟ الرياض #السعودية #الكويت #الامارات #العراق #مصر #السودان	OBJ
دي بجد هي؟ انت متأكد؟	OBJ
#لو_كان_السادات_عايش كانت مصر من أكبر الدول المنتجة و كانت ضمن مجموعة الثمانية رحمة الله عليك يا أسد العرب و قاهر اليهود	OBJ
شاهد - القضية واحد واحد واحد صفر في آخر كلام #	NEG
باسم يوسف قال هكمل النص مليون قبل بلال فضل وبعدين #فسسسسس	OBJ
جولة #السوري الحر بدرعا || جولة مع أمير الإقتحام #جبهة النصرة في تل الجا: عبر	POS
هل اعتدى #الاخوان على الكنائس كما فعلت شرطة العادلي؟هل كمموا الأفواه وصادروا حريتكم وأنتم تسبونهم وتسخرون منهم ومن رئيس…	OBJ
تغطية لندوة دكتور عبد المنعم ابو الفتوح فى كلية طب - جامعة الإسكندرية اليوم	OBJ
بالفيديو- #فيفي_عبده تشكر على الهواء #1	OBJ
الحاجه بت الوسخه #الصح لما كل مصيبه تحصل ف البلد اول اتنين بينامو #مصطفى_حسنى #عمرو_خالد	OBJ
#ذات_مومنت لما الكهرباء تقطع وانت لسه شاحن التابلت عادي بقي اقطع براحتك	OBJ
شاهد - آخر كلام: من يدفع في النهاية فاتورة الألم #	OBJ
#خلق_جميل الشعور بالغير	NEG
خلاص يازين من حبهم عزلنا #اكتب_عبارة_على_باب_قلبك	NEUTRAL
دورالمرأة المصرية ضدالإنقلاب كان تاريخيا ومذهلا في الإعتصامات والمسيرات فمنهن الشهيدات والمصابات والمعتقلات المرأة مصنع ال…	OBJ
قصة عمّار مُلهمة! قصة الشاب عمار بوقس الذي لا يتحرك فيه الا لسانه وعينيه وحقق مالم يستطع تحقيقه الآخرين!	OBJ
يومك يناديك و يقول أنا يوم جديد على عملك شهيد فأغتنمنى فإنى لا أعود إلى يوم القيامة	OBJ
حد #بيحبك + حاسس #بيك + بيسمعك من غير ما #يفهمك غلط + #فاهمك حتى لو ما عرفتش #تعبر كويس عن اللى #جواك = #ربنا :)	OBJ
حكاية حلم انتهي #ثورة_25_يناير	OBJ
#صدر_حديثا لدى #دار_المحدث (التَّيسيرُ بين المشروعِ والممنوع) "الإشراف" #معرض_الكتاب	OBJ
دمعة فتاة تنتظر الفرج #جمعية_زمزم #كن_سباقا_لعلاج_المرضى_الفقراء #العريفي #رمضان #رتويت #القرآن …	OBJ
#متصدر_لاتكلمني, #النصر_الشباب, #الهلال, #اكشن_يا_دوري شجع ناديك بدون تعصب مع برنامج الايفون الرائع 636	NEG
#تنويه_البرنامج لو جنبك عيل وخايف عليه وفاكر ان الالفاظ اللى هتسمعها فى البرنامج هتفسد اخلاقه يبقى لامؤخذه قوم انت لان	OBJ
مظاهرات المهندسين تتجاوز ربع المليون بين شارعى شهاب ووادى النيل ما شاء الله على شعب مصر العظيم سيسقط الانقلاب باذن الله	OBJ
تكريم الجنزورى وا?ستعانة بخبرته كمستشار رسالة الى كل رجال العهود السابقة ان مصر فى حاجة الى خبراتهم وأنه ? تهميش و? إ	NEG
آخر كلام: د عبدالمنعم أبو الفتوح - موجة الثورة الثانية	OBJ
#الوفد ضبط 6 إخوان بحوزتهم منشورات مناهضة للجيش والشرطة: ألقت مباحث الإسكندرية القبض على 6 أعضاء #الوفد	OBJ
كان حلم حلو فى اوله شوقنى انى اكمله  #25_يناير	NEUTRAL
كيف نتفاهم ونتحاور؟ كيف يحترم ويقدر بعضنا بعضاً ؟ كيف نبحث عن مساحة مشتركة فيما بيننا، ونبني جسوراً لا حواجز	OBJ
موعد صلاة العصر-#بوسطن(الذين يقيمون الصلاة ويؤتون الزكاة وهم بالآخرة هم يوقنون(4)أولئك على هدى من ربهم وأولئك هم المفلحون(5))	OBJ
نظم أهالى #المطرية الجمعة مسيرة مناهضة للانقلاب العسكري ، استجابة لدعوة التحالف الوطنى لدعم الشرعية ، انطلقت من	OBJ
#الوفد مصر للطيران: "كورونا" لم يؤثر على حجوزات العمرة: أكد الطيار هشام النحاس رئيس شركة مصر للط #الوفد	OBJ
عندما تقرأ أن السعودية والامارات والكويت والاردن تؤيد التحول الديمقراطى فى مصر بعد الانقلاب تموت من الضحك 4 دول	NEUTRAL
يا ريت !	OBJ
طوابير الدستور كانت بصراحة مهزلة	OBJ
أعلنا اليوم تأسيس حزب الدستور الجديد في جو مليء بالحماس والتفاؤل وفقنا الله لما فيه خير الوطن	NEG
2 الانتخابات الرئاسية المبكرة تختلف جذريا عن الحديث المرفوض بالكامل لإسقاط رئيس منتخب بالعنف، وعن المطالبة المرفوضة بالكامل بتدخل الجيش	OBJ
أما المواقع الإباحية على الانترنت، والتي هاج وماج المتشدقون بالدفاع عن الحرية، فتخضعها الكثير من المجتمعات الليبرالية لقيود مختلفة تصل للحظر	OBJ
علاقة النائب بالناخبين لابد وأن تراجع سنويا في جمعية عمومية مثلما تفعل الشركات مع المساهمين العقد بيننا هو البرنامج والعقد شريعة المتعاقدين	NEG
وصول الثوار لميدان التحرير احد اكبر علامات اسقاط الانقلاب والعلامات الكبرى والاخرى قادمة مع قادم الايام	POS
لا أحد فوق القانون د عبد المنعم أبو الفتوح	OBJ
اللى هيدوس لااااايك هبعتلواااا ادد #ميدو	OBJ
لن ندخل في حرب مع أحد لان مشروعنا الرئيسي هو بناء الوطن وجزء من هذا بناء جيشنا ليس من أجل الاعتداء على أحد ولكن	OBJ
تنور !	NEG
كان فيه إستفتاء على تعديل 8 مواد في الدستور وبعد كده أصدروا إعلان دستوري من حاجة وستين ماده دون إستفتاء ده قانوني؟	OBJ
_ صحيح ولهذا كتبت في تغريدة تالية:	OBJ
ننتظركم في ندوة التوقيع الأولى لـ"نادي السيارات" لدكتورعلاء الأسواني بدار الأوبرا المصرية الجمعة القادمة بإذن الله >>	POS
استفتاء المصريين في الخارج يوم السبت اجراء شكليمعظم المصريين لن يتمكنوا من التصويت لضيق الوقت وتعطل مواقع القنصليات الاليكترونية من الان	OBJ
اللهم انصر المجاهدين واهلنا في #سوريا على بشار وشبيحته وحزب الات وايران وجنودهم وطغاة الروس الشيوعيين اللهم عجل بنصرك لاحبتنا في الشام ,	OBJ
#جبهة ثوار سوريا - القطاع الجنوبي : القنيطرة تمكن المجاهدون ضمن معركة #صدى_الأنفال صباح اليوم بفضل الله من	POS
تعديل كامب ديفيد ليس رفاهيهنلزم الحكومه بما صدر عنها من بيان بسحب السفير و نصف التراجع بالعار و الخزلانلا شيء يعلو علي كرامه المصري	NEUTRAL
الدعوة الى ائتلاف ثوري يضم الاخوان لم يعد لها معنى لان التزوير أوضح من الشمس المعركة الان اما لتطبيق القانون او مقاطعة الانتخابات	OBJ
_ مش قالولك متهنيشويلك ويلك على كل شكرا	OBJ
عرض الاسبوع نشط #متصدر_لاتكلمني #غرد_بطولك #بعد_منتصف_الليل #سعودي_ليق #عبدالله_العذبة	OBJ
هذا أوان توحد القوى المدنية والثورية معا لاستكمال أهداف الثورة ومواجهة أى محاولات هيمنة أو انفراد من أى طرف معا نبنى التيار الشعبى المصرى	OBJ
هذا الحساب لكتاب رسائل سجين سياسى الى حبيته ( فـــــــقـــــــــط ) وكلما تنتهى الرسائل ستعاد من جديد شكرآ لمتابعتكم	OBJ
78 الدكتور عنده ندوة في الاسكندرية الاسبوع القادم وكان لديه جولة ميدانية في الجيزة الاسبوع السابق	NEG
سعودي قال ان الحسنة الوحيدة لدعم بلاده للانقلاب بمصر هي التعجيل بثورة في السعودية تظهر ارهاصاتها منذ فترة بعد تعرية الغطاء ا…	OBJ
حان الان وقت صلاه المغرب لــ #نيويورك #امريكا 7:50 ,	OBJ
من صوتوا لمرسي وشفيق لهم نفس حقوقنا كمواطنين ولا ينبغي، مع الاختلاف في الرؤية للدولة والمجتمع وللحريات والمدنية، الانتقاص من أهليتهم	NEG
قال رسول الله صلى الله عليه وسلم : ( إِنَّ مِنْ عِبَادِ اللَّهِ لَأُنَاسًا مَا هُمْ بِأَنْبِيَاءَ وَلَا	NEUTRAL
تخللوا أنتم وواقعكم~ #نوبة جنون	OBJ
وقار الدين : يدعو إلى نصرة مسلمي #الروهنجيا في جامعة أمريكية #بورما #أراكان #ميانمار	OBJ
تعقيبا على تشكيل الجمعية التأسيسية للدستور	OBJ
عشرون ملاحظة على مشروع الدستور للقاضي أحمد عطية أبو شوشة - تستحق القراءة	OBJ
باراك #أوباماقرار الرئيس الفلسطيني محمود #عباس تحقيق المصالحة مع حركة#حماس "غير مفيد" غير مفيد لمن؟ ومن يقرر ذلك؟ "	OBJ
بيان صادر عن جبهة الضمير (بمناسبة مناقشة قانون السلطة القضائية بمجلس الشورى اليوم): تتوجه جبهة الضمير للسادة	OBJ
لمن كان يسأل عن عنوان #ديوان_شيبان الذي يقام فيه #درس_الاثنين #الفحيحيل قطعة 9 شارع المخفر #انشر #الكويت …	NEG
ياباشمهندس لو الرقم اللي هم بينشروه عشان يبعتولك عليه تهديدات ده رقمك بجد، من حقك تبلغ الأمن الوطني يتتبع أتصالا…	NEUTRAL
فن خسارة المعركة اقرأ المقال كاملا على موقع #الشروق	OBJ
وأرجو من الميرازى أللا يعالج خطأ مهنى وقع فيه بخطأ آخر أخلاقى لا يليق به ولا بتاريخه الناجح, وأرجوه الإجابة على السؤال الأتى: يتبع	OBJ
د أبو الفتوح : مشروعي يتركز في أربعة محاور، أولها الاهتمام بالتعليم والبحث العلمي لان هذا هو الباب للتقدم ونقل	NEG
أول ما الإخواني يتزنق يقولك هناك ملائكة تسجل ماتقوله طيب مش هي الملايكة بتسجل كذب قياداتكم ولا هي بتسجل لنا إحنا بسإتقوا الله ياإخوة	OBJ
_ مايصحش أقول	NEG
انتا عارف حتي تعشق حد غيرهادا انتا وانتا ويا غيرها بتفتكرها #عمرو دياب️	OBJ
#ولاد_البلد #المنصورة تفريق مسيرة لعناصر "الإخوان" في #سمنود بعد الإشتباك مع الأهالي بمنطقة الشحاتية	OBJ
زوجة #متعب على " #فيس_بوك ": " #الشرطة مينفعش معاها غير معاملة #الألتراس "	OBJ
من إنجازات الثورة العظيمة هو مشاركة الشعب في المعادلة السياسية ليؤكد أنه أهم لاعب	NEG
قد ترى الأمور مستعصية عليك بعض الشيء لكن اذا ما نظرت من ذاك الباب الذي لا ينظر إليه احد سوف ترى الأمور متجلية واضحة ومفهومة لديك #حاول	POS
أتحدث على أون تي في بعد قليل	OBJ
وصول الفضائيين لليبيا يعني اقتراب الهجة #كن_متفائلا	OBJ
يا استاذنا العزيز ﻻ تكاد تويتات حضرتك تخلو من ذكر #اﻻخوان أين أنتم من المعتقلين و مجزرة #رابعة_العدوية إنظر إلى…	OBJ
3 مصر تحتاج لانتخابات رئاسية مبكرة، وبالمطالبة بها التزام خالص بالديمقراطية وليس انقلابا عليها كالدعوة لإسقاط الرئيس المنتخب بالعنف والفوضى	OBJ
#اكتب_عبارة_على_باب_قلبك اركد الله يهديك : \	OBJ
الان و بعد المناقشات الجميلة دي،اسمحولي انزل ببلوكات على حبة عيال سيس مالهاش الا كلمتين حافظينهم و شوية شتايم يالا من هنا حنرش	OBJ
لإمتحانات 3-5 و أنا لسه عارفة النهاردة و انتوا تقريباً كنتوا عاملينها مفاجأة ! #جامعة_المنصورة #كلية_تجارة	OBJ
,عندما يعود المجارب من حربه مع العدو يدخل في حالة نفسية سيئة جراء مشاهدته لكل هؤلاء القتلي ٣٠ #مذبحة_بورسعيد	OBJ
افضل لاعبي الدوري الانجليزي في سنة : ٢٠٠٩ #رونالدو في الصيف الذي يليه انتقل الى الريال ٢٠١٣ #بيل في الصيف الذي	NEG
لو #دمعتك نزلت على خدك من كتر ضيقتك اعرف ان #ربنا بيقولك اسند رأسك على #بابى	POS
إعلاميون بلا حدود - #الرقة || #هام يقوم الآن عدد من عناصر الدولة الاسلامية في العراق والشام بحملة اعتقالات	OBJ
برنامج مش صعبة د حمزاوي شرح مصطلح "الأمن القومي ":	NEG
بدل ما تطلع تقول قدمنا اولادناما تقدم نفسك يا أخي #السادة_المحترمون 2 …	OBJ
شايفين العيب و الغلط ومبنسالش حتى ليه وكل واحد بيقول هو يعنى بايدى ايه !! #كاريوكى	NEG
صورة من كواليس إحدى حلقات برنامج (قصة الأندلس) المنتظر عرضه في رمضان القادم يمكنك مشاهدة برومو البرنامج على	NEG
#متصدر_لاتكلمني, #النصر_الشباب, #الهلال, #اكشن_يا_دوري شجع ناديك بدون تعصب مع برنامج الايفون الرائع 789	OBJ
بوابة الشروق| بالصور أفضل 27 لقطة مضحكة في حفل توزيع #الأوسكار # "	OBJ
إذا جرحت إحدي الطيور أثناء طيرانها في سربها تهبط ويهبط معها طائر أو إثنين كن كالطير وساعد غيرك	OBJ
ندوة الدكتور عمرو حمزاوي بالهيئة العامة لدِار الكتب والوثائق القومية 14-مارس-2012	OBJ
م اظن فيه انسان مسلم يرتضي سفك الدما ! #خليجيون_ضد_الدماء #مجزرة_رابعة_العدوية	NEG
انت شفت الحك ولازقة فيه كدهو! وبدل ما كانت بتسبح ف البسين ! سبحت ف أعماقه مع المعرصين #انتخبوا_العرص	OBJ
حب البلد بيعيش لما يموت الجوع #حمزة_نمرة مهما كلت وشبعت برضو مش بحبها	NEG
#المصريون | رئيس #الوفد يقرر عودة المفصولين من خلال تقديم تظلم أكد المتحدث الرسمي لحزب الوفد المستشار بهجت	OBJ
ابو ام #مرسي اللي خلي بتوع مبارك يفتكروا نفسهم ثوار وكلنا واحد وابو ام #السيسي اللي خلي الاخوان يفتكروا اننا واحد …	OBJ
هو بس سؤال رفيع للإخوان: بالنسبة لرجال الأعمال اللي كان رئيسكم بيكلمهم بكل حنية ودلال مش دول برضه الفلول اللي صدعتونا إنهم بيتآمروا عليه؟	NEG
لن يأتى عام 2014 الا وديون مصر تسجل رقما عالميا لم تصل اليه اى دولة ولن ينفعنا مليارات الخليج الملوثة بدماء اولادنا	NEG
لو بتخاف عليها أكتر ما بتخاف على نفسك ، بس بجد مش تمثيل قدام الناس #مبروك_انت_راجل	OBJ
"التسعيرة الجبرية" مزيد من النهب محمد البرغوثي #السادة_المحترمون	OBJ
البيت الأبيض يعلن أن قطر والإمارات وقعوا بيان التحرك العسكري ضد سوريا #السادة_المحترمون …	OBJ
هواجس العام الجديد - ثانينا عن مسار الاحتجاج الشعبى والحالة الثورية - عمرو حمزاوي - بوابة الشروق	NEG
#الوطن| إصابة سيدة بطلق ناري في مشاجرة بين شيخ بلد ومساعد شرطة بـ #بني_سويف	OBJ
عدد القنوات ومساحات الاعلانات الكبيرة وعدم وجود ضوابط نزلت سعر الدقيقة للارضعاملة زي فنادق سيناء اللي بتحرق اسعار وبتجيب سياحة رخيصة	OBJ
#حمدي_قنديل انت مقتنع باللي بتقوله ده؟؟!!	OBJ
البقية فى حياتك كان راجل عظيم	NEG
قانون الضرائب الذي يتم تطبيقه على اسرة ساويرس هل هو ذات القانون الذي يطبق على خيرت الشاطر وحسن مالك ام ان القانون يتعطل امام أثرياء الاخوان	OBJ
#جنايات_المنيا : تصدر حكماً بإعدام 37 إرهابيا اخوانياً وبحبك 492 لمده 25 عاما في قضيه اعمال العنف بمطاي بعد عزل الرئيس الخائن #محمد_مرسي	POS
مش معقول يا جماعة أنا هتفاءل لوحدى شدوا حيلكم معايا و " مدد مدد شدى حيلك يا بلد "	OBJ
إلى الشعب بكل طوائفه مطلوب التوحد فورًا حول أهداف الثورة وأن ننسى خلافاتنا الضيقة حتى يستعيد كل مصري حقه في الحياة الحرة الكريمة	OBJ
_25 جميع أرقام #الأهلى #مصر في #دوري_أبطال_أفريقيا من البداية وحتى 2017	OBJ
الجيش يغلق 3 محطات مترو ويوقف حركة القطارات ويغلق الميادين الرئيسية بالقاهرة!! مش انت قلت دول مش الشعب ومجرد شرذمة واخوان …	OBJ
الدكتور محمد الفخراني ابن اخت النائب العام الجديد من اشد مؤيدي الاخوان في ولاية ميشيجن بامريكا	OBJ
البرلمان اتحل ورجع واتحل وناس تزيييييط واقلبوا على مرسي وناس تزيييط ويقولك الاخوان مثبتين العسكري واحنا نتوتر ونشتم بعض وفي الاخر فسسسسس	OBJ
ﻭﻗﺎﻝ ﻝَﻡَّﺍ ﺣﻮﺻﺮ ﻓﻲ ﺩﺍﺭﻩ: يبيت ﺃﻫﻞ ﺍﻟﺤﺼﻦ ﻭﺍﻟﺤﺼﻦ ﻣﻐﻠﻖ ﻭﻳﺄﺗﻲ ﺍﻟﺠﺒﺎﻝ ﺍﻟﻤﻮﺕ ﺷﻤﺮﺍﺧﻬﺎ ﺍﻟعلا #عثمان_بن_عفان	OBJ
في حفل جمعية رسالة " رد الجميل " لتكريم سيدات مُسنات من جميع محافظات #مصر بمناسبة #عيد_الأم على مسرح سيد درويش - أكاديمية…	NEUTRAL
حازم #الببلاوى: الحكم العسكرى انتهى و #السيسى الضامن الوحيد لعدم عودته فييييييييين انشراااااح ؟؟؟؟ #أنا_حازم	OBJ
هدير طلاب الجامعة يشكل فيضانا لن توقفه سدود الانقلاب الشرعية ستعود ان شاء الله	NEUTRAL
الذين يدعون ان هذه الثورة العظيمة هى انقلاب عسكرى يجهلون او يكذبون وفى الحالتين يهينون الشعب المصرى ويستهينون بتضحياته وبدم شهدائهم الأبرار	NEUTRAL
": #تركيا كبير القضاة يتهم #أردوغان بـ "فساد الضمير" ويتعهد صون كرامة الأتراك وحرياتهم "	POS
_ اتفضل	OBJ
دور #البرادعي على المستوى الدولي كسفير ل 30يونيو يبعث برسائل للعالم كله انها ثورة شعب وليست انقلاب كما تصور أمريكا لن ينساه …	OBJ
الأسواني: لقد أثبت مرسي أن الاسلام الحقيقي العظيم الذى نعتنقه ونعتز به يختلف الى حد التناقض مع المقال كاملاً >> …	NEG
شاهد - الكاتب والأديب الكبير د علاء الأسواني وحوار شامل في آخر كلام	OBJ
الحمد لله تملأ الميزان	POS
فلنبدا من جديد عيش حرية عدالة اجتماعية قولوا معاياو الاخوان #كلام_و_كلام #يوسف_الحسيني #…	OBJ
صباحى ينفى صحة تسريبات محاكمة السيسى وحملة #المشير: تصرفات غير مسئولة ,الشروق #مصر	OBJ
اعداد الطلاب المعتقلين اليوم فاق اعداد الطلاب الذين دخلوا الى المحاضرات العام الدراسي سيكون فى الشوارع حتى سقوط الانقلاب	OBJ
لعن الله البغاة! #ريت…	OBJ
ممكن يبقى إسمك سكينة بس تبقى أرجل بكتيييييييييييير من واحد إسمه أحمد	OBJ
11 "افتتاح الملتقى الأول لصناع الحياة"	OBJ
ماحدش عنده #ضحكة سلف ؟؟ # - يشعر بـ الحزن	OBJ
1968 فيما يخص الجانب الفقهي يمكنك سؤال الازهر ودار الافتاء	NEUTRAL
مصر تقع في مجموعه ناريه ناريه #مصر #تونس #السنغال #موزمبيق او #جنوب السودان #حسن_شحاته كان بيرتعش وهو بيسحب القرعه #_	POS
لاحظت المصادر تقدم واضح في أسلحة الجهاديين في سيناء واستخدام مضادات للطائرات والمدرعات استخدمت في مواجهة الجيش ومواطني المد…	POS
محسن شعلان (مبقوق سابقا): "ثمن الخشخاش لايتجاوز 800ج و قيمتها في اسم فان جوخ" دا إيه الذكاء الخارق ده؟	OBJ
وشرف الأخت #صافيناز لانجح السنة دي :)	OBJ
خليك بتاع كله عشان كله يبقى بتاعك #اسلوب_حياة	NEG
- #اسرائيل #عباس	OBJ
قطار تحرير العالم العربي من الاحتلال المحلي غادر المحطة ولن يتوقف أبشروا، الحلم يتحول سريعًا إلى حقيقة	OBJ
#أشاهد_الآن #صديقات_العمر_الحلقة_1 على شاهدنت عبر	OBJ
كل أجهزة ومؤسسات الدولة, الازهر, الكنيسة,وحزب ال	OBJ
أذا أقنعت شابا بالكذب بانه يجاهد في سبيل الله ثم أعطيته مسدسا وجعلته يطلق النار على ضابط شرطة فقام بقتله ستكون انت من قتلت الشاب مع الضابط	NEG
اليوم السابع | مدير #مرور #البحيرة: جارى تركيب كاميرات مراقبة بشوارع #دمنهور	OBJ
الوطن | لماذا لا يريد الإخوان انتخابات الآن؟ | عمرو حمزاوي:	OBJ
مستورد استغل الفساد ودخل حاويات مبيدات حشرية من 13 سنة واكتشفوا انها نفايات نووية خبر في الأهرام ومستغربيين بيجيلنا س	OBJ
احبسونا و امنعونا #البعد عن #الاهلى محااااال	NEUTRAL
#جمال #خيال #حقيقه #جميل #درر #حكم #أعجبني #حكمه #بقلمي #شوق #بوح #شعر #قصيد #رتويت خمس الاف متابع بـ 200 ريال 132	POS
هو ممكن ت #نزل_صلاح :( #ليلة_الابطال	NEG
ليس سيئاً تماماً أن نري الشفيق هارباًصحيح القصاص حلولكن العار برضه حلو	OBJ
سوري الرابط اهه	NEG
خدت موافقة خيرت الشاطر على التويتة دي يادكتور فاضل؟	OBJ
وأنا بصراحة لا أحب الناقص ولا اللي بيناقص	OBJ
#السادة_المحترمون حلقة الإثنين 21 أكتوبر 2013 كاملة لقاء العقيد خالد عكاشة، الأستاذ أحمد بان …	OBJ
هام: لماذا لم تقنن جماعة الإخوان المسلمين وضعها غير القانوني؟	OBJ
جريده نيويورك تايمز اهم صحيفه في العالم اختارت 25 كاتبا علي مستوي العالم لينضموا الي كتاب الجريده و كنت واحدا من هؤلاء الكتاب الحمد لله	OBJ
#عادل_الفقيه_وزير_الصحه_والعمل #فيفي_عبده_الام_المثالية	OBJ
شاهد - يسري فوده: ومن يأمن لمن قال يوماً "طز ف مصر" #	NEG
#نجم_الدين #عمرو_جمال تحبا في الله اجتمعا عليه و تفرقا عليه و كانت النهايه انهم يتمسكوا مع بعض #الحريه_للجدعان #الحريه_للابطال	OBJ
والله من شين النفس فيني اليوم #اعتراف	NEG
لا إله إلاَّ اللَّه وَحْدَهُ لا شرِيكَ لَهُ، لهُ المُلكُ ، وَلهُ الحَمْدُ ، وَهُوَ عَلى كُلِّ شَيءٍ قَدِيرٌ #غرد_بذكر_الله #كنز_المسلم	NEG
#خيرت_الشاطر قال أن من أخطاء #الحرية_والعدالة أنه لم يضم أعضاء #الحزب_الوطنى إليه #…	OBJ
يا الله أنت العزيز الجبار ليس لنا ملجأ ولا ملاذ سواك أنت ترى وتسمع وتعرف الاسرار اذا كان عبادك المطالبين بالشرعية	OBJ
#إبراهيم_محلب يعلن افتتاح خط طيران #القاهرة - #إنجامينا عاصمة تشاد أول أغسطسويكلف وزير الطيران باتخاذ الإجراءات	NEG
و لعل أسوء ما في هذا اليوم غيابك يا #باسم :-( = =	POS
#لما اوحشك غمض عينيك وانده عليا انا هسمعك وهحس بيك وتحس بيا صورتى ف ايديك بوسها بعنيك وبعتلى ورده #وياك	OBJ
حشود ضخمة في مسيرة #المطرية اليوم الجمعة 1-5-2014 #شير	NEG
الأرصاد: طقس اليوم معتدل وشبورة مائية بالقاهرة والوجه البحري #مصر #ميدان_التحرير	OBJ
اعتصام ابو اسماعيل وجماعته امام مدينة الانتاج الاعلامي حدث بموافقة مكتب الإرشادالاخوان يريدون ارهاب الاعلام الذي يكشف جرائمهم لن يفلحوا	OBJ
بسمة أمل - العون من الله علي قدر النية قصة من التاريخ الإسلامي بطلها خالد بن الوليد حدثت عندما كان	OBJ
#حقيقه #بوح #شعر #روعه #السعودية #الكويت #الإمارات #قطر #البحرين #نكت #الصور #الرياض #حائل خمس الاف بـ 200 ريال37	OBJ
مهما حدث لك شر كان أو خير فلا تدع الناس يعرفون عنك سوى سعادتك ولا يرون مــنك إلا ابتسامتك فإن ضاقت عليك	OBJ
المصريين	OBJ
#ثوار #المرج #عزبة_النخل #المطرية #عين_شمس ما نبقاش رجالة لو ماطلعناش ال 5 سيدات من #قسم #المرج الليلة #مرسي #الاخوان #انتخبوا_العرص ريتويتِ	OBJ
ورغم انى جـدع وتقيل و عمري ما أقولهـآ بالساهل انا نفسي اقولها لك ف اول مره نتقـابل #محمد_محسن	OBJ
البسوا يا بتوع 30 سونيا #ميدو	OBJ
#ﻣﻘﺪﺭﺵ_ﺍﻧﺴﻰ اول هدية جاتلي 3	OBJ
#ليه بنخاف من الموت و هو الحاجه الحقيقيه في الدنيا !"	POS
وأكبر جريمة ختم بها #المجلس_العسكري فترة حكمه للبلد إنه سلمها لـ #الاخوان وهذه هي الكارثة	OBJ
#لو_ده_جنان_اتجنن واكتب على غلاف ورقة الاجابه "اوعا تفتح الورقه ارجوك,,ارجوك"واكتب فى الورقه الي بعدها "برده فتحتها ياحيواااان "!!	OBJ
(التيار يدين العنف وحرق المقرات) #التيار_الشعبي	OBJ
"_: #أوباما: لا نتوقع أن نقوم بتسليح #أوكرانيا وأي تسليح لايمكن أن يردع السلاح الروسي#أميركا #روسيا #العرب"	OBJ
انا مش طماع نبدأ بريتويت وربنا يسهل فى الفولو دا احنا داخلين على ايام مفترجه	OBJ
عدد من ضباط الجيش موجودون بالمدارس هل وصل الخلل الى هذا الحد؟	OBJ
فضلت اتريق على اللي شغلهم الساعة 8 واتريق واتريق لغاية ما مطلوب مني في 10 دقائق اكون لابس ونازل وخمس دقائق وابقى فى الشغل #فجأة	NEG
3 تم الإتصال أكثر من مرة وستكون عندنا بالغد في لجنة حقوق الإنسان	POS
تحية لرجـــالة #الإتحادية ;) يا ريتني كنت معاااااكم	OBJ
": #مصر_القوية | جانب من مسيرة #ثوار المشارك بها الحزب في طريقها إلى #الإتحادية "	OBJ
الحفاظ على الأمن والإستقرار لا يعنى ولا يستلزم ممارسات تتعدى بشكل صريح أو مبطن على حقوق المصريين وحرياتهم	OBJ
بلغت سرعة هدف #كريستيانو_رونالدو الثاني أمام أوساسونا 101 كم / ساعة وهدفه رقم 101 في البرنابيو #هلا_مدريد"	OBJ
بيدونا اجازة فى عيد العمال عشان نقعد فى البيت نتفرج على فيلم الايدى الناعمة،حرام والله #أوقفوا_الفحم	NEG
أما الدفاع عن حقوق الإنسان للجميع بما فيهم الإسلاميين فيتسق مع مبادئي الليبرالية تماما كرفض الإتجار بأجساد النساء في المواقع الإباحية	OBJ
مدرسة الطبري بشيراتون	NEUTRAL
دعلاء الأسواني: لماذا غضب #مرسي من كلام الطبيب ؟! >> أقرأ المقال كاملاً علاى هذا الرابط >> …	OBJ
ضبط حشيش مع #لاجئين سوريين بالمفرق #شاهد التفاصيل من هنا:	NEG
شاهد - آخر كلام - نادر السيد: الثورة في الميدان #23 #	OBJ
#كلمه_بتتقال_في_البيت_كل_يوم جيب كاسه موووويا	OBJ
إقرأ كلام كبير ومهم عن الدستور	OBJ
#بيع_متابعين #زيادة_المتابعين #تابعني_اتابعك #السعودية #الهلال #النصر #الاتحاد #الأهلي #الأتفاق #الشباب [90332]	NEUTRAL
من أقوال أبو الفتوح: ليس هناك مجال للحرية بالمعنى المطلق، فلابد أن تنتظم تلك الحرية مع قيم المجتمع ومبادئه وأعرافه	OBJ
النشطاء، اللبراليون و الإعلام لزم الصمت أمام المجازر في #مصر #	OBJ
مجلس الشعب: أنا عضو في لجنتي حقوق الإنسان والشئون الدستورية ولم أترشح لا على رئاسة أو وكالة أي من اللجنتين ولم أصوت في انتخابات اللجنتين	OBJ
بعد أن كان 6 اكتوبر 1973 هو يوم انتصار الجيش للشعب ينتظر الجميع 6 اكتوبر 2013 ليكون يوم استعادة الشعب للجيش	OBJ
#بيع_متابعين #زيادة_المتابعين #تابعني_اتابعك #السعودية #الهلال #النصر #الاتحاد #الأهلي #الأتفاق #الشباب [90989]	OBJ
حتى في فرنسا متأخر عشان الريس معدي!	POS
إبطال مفعول قنبلة بدائية الصنع بجوار ميدان محطة #المنيا	NEG
#إنت_حر | #كارمن_سليمان ووالدتها تغنيان "حبيبتي من ضفايرها" ألحان الراحل #عمار_الشريعي في مع #…	OBJ
_ ابو الفتوح بيعبر عن رايه وما يمليه عليه ضميره وما يراه في صالخ نجاح الثورة,	OBJ
خبر عاجل #تعليق_الدراسة #بوح #درر #حكم #غرد_بصورة #الهلال #النصر #الشباب #الأهلي #الاتحاد #اكشن_يا_دوري #14 27	OBJ
تابعوا الأن #نقطة_لقاءضيف #يوسف_الحسينى السفيرعزت سعد,السفير السابق في موسكو	OBJ
استشهاد جنود مصريين على الحدود بنيران صهيونية جريمة غير مقبولة دماء هؤلاء الشهداء تستدعى موقفا جادا حفاظا على كرامتنا وصيانة لحدودنا	NEG
وقد قالها المتنبي العبقري فينا من زمان:أغاية الدين أن تحفوا شواربكم ياأمة ضحكت من جهلها الأمموقد أضفنا لحف الشارب التشطر بحرق حتت القماش	OBJ
#نبض_رابعة #ضد_الانقلاب #حاميها_حراميها #المنصورة إستجابه للتحالف الوطني لدعم الشرعية في أسبوع #حاميها_حراميها	OBJ
اقولك على حاجه!! الدنيا مش محتاجه! #اه_والله	POS
بطيء عندما تنتظر، سريع عندما تخاف، طويل عندما تحزن، قصير عندما تفرح،،،	OBJ
# #نافذة_مصر | #الاسكندرية : قطع العشرات من طلاب المعهد العالى للهندسة بالكيلو 47 #2011	OBJ
"_: "الدستورية": المحكمة جاهزة للقيام بواجبها في عزل الرئيس لأول مرة في تاريخ مصر "	OBJ
يلا يا شباب عايزين نجمع ال 30 الف توقيعياريت كل اللي جمع توقيعات ورقية يدخلها على الموقع ده	OBJ
أنا لم أصوت في انتخابات الرئاسة 2012 ولكني كنت مع د #مرسي في الإعادة أمام #شفيق …	OBJ
#ذات_مومنت اما يجي #حبيبيك ويقولك ما #تيجي نرجع زي #زمان __ امك #قرعه واسمها #حنان 3:) #شقية	OBJ
علاء الأسواني: كيف يتخذ الرئيس يتخذ الرئيس مرسي قراراته ؟! >> أقرأ المقال كامل >> …	OBJ
الغريب انها فخووورة بنفسها #الحكم #فيفي_عبده_الام_المثالية !	OBJ
اللى كان بيدعم #أبوالفتوح فى الجوله الاولى بيدعم حمدين دلوقتى و كتتيييييير من اللى كان بيدعم #حمدين بيدعموا #السيسي !! ه…	OBJ
يتناول #يوسف_الحسيني اليوم نتائج زيارة رئيس المخابرات العامة المصرية ووزير الخارجية ومساعد رئيس الجمهورية لواشنطن …	OBJ
أكد لي مصدر قانوني مسئول أن اقتراح انسحاب مرسي من الإعادة ومن ثم فتح الباب لمنافسة بين صباحي وشفيق يجوز قانونا قبل إعلان النتائج النهائية	OBJ
النيابة تحقق مع البلتاجي في قضايا الاتحادية والحرس الجمهوري ( اللي كل القتلي فيهم اخوان ماعدا الصحفي الحسيني ابو ضيف) #مصر	OBJ
_ #عدلى_منصور #سيناء #القدس اسمها مدينه القدس وليست القدس الشرقية ياجاهل	OBJ
#الفرسان_كورة | اخبار | #وائل_جمعة أساسيا فى مواجهة #الأهلى_والدفاع_المغربى	OBJ
شاهد - آخر كلام: سد النهضة ما ينبغي على مصر فعله #	NEG
د علاء الأسواني يكتب مقاله الاسبوعي بعنوان: ملاحظات صريحة على مسار الثورة	OBJ
برنامج مش صعبة د حمزاوي شرح مصطلح "الصمت الانتخابي":	OBJ
#تعارف_بلاك_بيري #لستات_بلاك_بيري #قروب_بلاك_بيري #اضافات_بلاك_بيري #الخبر #عاجل #الدمام #الجبيل #الرياض #ريتويت	OBJ
في ظل أوضاعنا الحالية أفضل أن يكون اختيار قيادات الجامعة بالانتخابات ليست هذه الوسيلة الأفضل مطلقا لكنها	OBJ
مهزلة كرة القدم في العالم !! #الفيفا #السعوديه #مهزلة_تذاكر_البريد #بربسه	OBJ
تجربة الانتخابات التونسية النزيهة واقبال الشعب التونسى على ممارسة حقه فى التصويت يؤكد نجاح الثورة التونسية مبروك يا تونس وعقبالك يا مصر	OBJ
تصويت جماعي وتوجيه ناخبين وغياب القضاة ومنع أقباط من التصويت	OBJ
#ثوار #المرج #عزبة_النخل #المطرية #عين_شمس ما نبقاش رجالة لو ماطلعناش ال 5 سيدات من #قسم #المرج الليلة #مرسي #الاخوان #انتخبوا_العرص ~ٍ	POS
اليوم اكتشفنا ان حكومة قنديل التى ذبحوها بدعوى الفشل هى الانجح فى تحقيق فائض بالميزان التجارى لمصر فى 50 عاما اعلام قذر	OBJ
غدا ندوة للدكتور عبد المنعم أبو الفتوح بنادي هليوبلس الساعة 8 مساء	OBJ
حساب عن سيرة سيد الخلق محمد بن عبدالله عليه افضل الصلاة والسلام انشر ولك الاجر #الرسول #النبي #محمد	OBJ
#بني_سويف | مظاهرة نسائية حاشدة ضد حكم العسكر بمدينة بني سويف #	OBJ
#لو_ده_جنان_إتجنن ادخل محل أيس كريم وخلّي البياع يدوقك كذا نوع، بعدين قوللو أنا كده شبعت الحمد لله وامشي	OBJ
إبراهيم الهضيبي ونادر بكار يناقشان السلفية في آخر كلام 11م	OBJ
صديقي مرسي بالقرب من دواسة البنزين التي لا تريد أن ترفع قدمك من عليها (الى يسارها) دواسة فرامل جربها كي لا نلبس في الح	OBJ
مصر ستبقي متأججة على فوهة بركان طالما بقي الانقلاب جاثما على صدرها بين شعب غاضب ثائر ونظام قاتل جائر	OBJ
#الأهلي #النادي_الملكي مايميز #الملوك لباقة الحديث واختيار أحسن العبارات #حملة #لا_للتعصب #لا_للبذاءة #لا_للعنصرية	OBJ
أحلام مصرية فى المسألة التركية فجأة ، إنفجرت و إنقلبت بعض الآراء المصرية ضد أردوغان 180 درجة ، فما هو السبب	OBJ
لا تجعل الطريق يأخذك حيثما يتجه بل إذهب حيث لا يوجد طريق و اترك آثارك	NEG
في أول رسالة فيديو عبر موقعه حمزاوي: أشكر من لم يعطني صوته وسأدافع عن الدولة المدنية - بوابة الأهرام	OBJ
نحن فى معركة الحرية والكرامة والعدالة من كانت قضيته غير هذا فهو يسير فى الطريق الخطأ #ثورة_يناير #وعى_الثورة	OBJ
#مش_ساكتة عشان الناس #مش_ساكتة عشان ده حقى #مش_ساكتة عشان مش غلطى #مش_ساكتة عشان انتى اقوى من المتحرش	NEG
من مشاكل تويتر هو الشعور بضرورة التعليق على أي حدث بشكل سريع حتى لو كان غير مكتمل التفاصيل، وكل واحد بيبني رأيه حسب انحيازاته واتجاهه الفكري	NEG
#فيلم_نفسك_تعيش_قصته #___	NEG
شموسه شنو احلى اغنية عجبتج من البوم #شيرين	NEG
#الشروق تعليقًا على فتوى "برهامي" لميس الحديدي: المواقع السلفية مواقع جنسية وحزب النور: دعم الشرعي #مصر	OBJ
سعوديون يطالبون الجيش المصري باختراع علاج لكورونا على شكل "صباع الكفتة" #اللى_رافضين_السيسى_رئيس_بيعملوا_فولوا_لبعض	OBJ
#يوسف_الحسيني هدف الإخوان في 19نوفمبر الوصول لميدان التحرير والسيطرة عليه #السادة_المحترمون …	POS
مدينة #السادات كانت كل المباني فيها تقريباً (مباني المدينة أو الجهاز) عليها سخانات شمسية	NEG
النهاردة إستئناف حكم معتقلي الازبكية بالحبس سنتين ومراقبة سنتين ، وجلسة تجديد حبس ٤٠ معتقل في احداث #جامعة_القاهرة ١٦ يناير حبة عدالة يارب	OBJ
هجوم مسلح على مبني الإذاعة بالعريش ومعسكر الأحراش برفح بصروخ من رفح الفلسيطنية وانفجار اخر داخل رفح الفليسطنية عن…	OBJ
") #شيرين	NEG
بسم الله الذي لا يضر مع إسمه شئ في الأرض ولا في السماء وهو السميع العليم مكملين ومنتصرين ان شاء الله اخلص النية	OBJ
تمثيليات الارهاب الانقلابية لن تتوقف بعد كل مذبحة لاحرار مصر يخرج الانقلاب بتمثيلية كاذبة ولا وجود لتفجير او رصاص فى القاهرة	OBJ
اووووووه نسيت !!! مفيش #برنامج #البرنامج مع #باسم_يوسف النهاردة!! :( غابت البسمة الليلة مفتقدينك يا #باسم !! #باسمون #مصر #بس_بقول	NEG
تكبيررررررررررررررررر مسيرة احرار #المعادى الان	NEUTRAL
3 انا قلت الكلامده فينانا بقولهم نقرا ونتناقشوانا مش باصادر على رأي حد انت حروانت حر	OBJ
سأسافر اليوم بإذن الله إلى أثيوبيا و أوغاندا ضمن وفد مصر الممثل فى وفد شعبي مع وزارة الخارجية المصرية إلى دول حوض	OBJ
"693: النِعمة تحتاج للشكر،، وَالبَلاء يحتاج للصبر،، وَالذنَب يَحتاجُ للإستغفار،، (فمْن شكرَ و صَبر وَ اسْتغفَر نَال #السعادة) 50"	OBJ
#باسم_عودة واحلى االبسمات	OBJ
قوات الاحتلال تقتحم بلدة جبع وقرية عنزة جنوب #جنين وتسلم عدداً من الشبان بلاغات للمقابلة	OBJ
سنحقق أهداف الثورة عندما نسترجع قيم أكتوبر: رؤية مستنيرة، خطة عقلانية مدروسة، عمل جماعي منضبط، إنكار للذات شعب واحد وطن واحد	OBJ
عرض الاسبوع 36 ألف متابع #وش_أكثر_شي_يسهرك #صيام_الإثنين #خد_موقف_من #صلاة_الوتر #فى_تويتر_تلاقى #الدمام [91766]	OBJ
قالت عضوةاللجنة اليكترونية ان من يرسم لهم الخطة استاذ علوم سياسية من الوطنى هناك اسماء يجب التشكيك في كلامها او تشويهها العمل 8 ساعات	OBJ
اعلام النظام السابق مازال قائماً : البلطجة الفكرية أقوى أسلحة اجهاض الثورة ماذا يحدث ؟!	NEG
متابع للدستور وكل مسوداته منذ شهرين تخيير الناس بين "نعم" للدستور و"لا" لاستمرار إعلان غير دستوري هو ما أتحدث عنه	NEG
إذا كان بيسمع الشيخ بيقوله ربنا خلق لنا الغرب الكافر عشان يخترع ويكتشف وإحنا ناخد على الجاهز لازم يصدق إشاعة زي دي طبعا	OBJ
وصلت المطار من الدقي في 11 دقيقة فعلا ساعة الحظر ما تتعوضتش	NEG
بلاغ للنائب العام مطلوب صاحب هذه الصوره الذى هدد نجيب ساويرس بالقتل والاعدام	NEG
#ثورة_25_يناير #باسم_رئيسا_لمصر #انتخبوا_العرص	OBJ
بيان حزب الوسط بشأن حكم الدستورية يوم 2/6/2013 يلاحظ حزب الوسط أن أحكام المحكمة الدستورية الصادرة عنه يوم الأحد	OBJ
#دعوة_الصائم_لاترد اللهم ارحم اخي #سلطان_ساب و اجعل قبره روضه من رياض الجنه يا سامع الدعاء	OBJ
أنصار شفيق أصابتهم نوبة بذاءة اليوم أنصحهم بإدخارمجهودهم , شتائمهم لن يقراها الدكتور علاء لأني أضعها في مكانها الطبيعي صفيحة القمامة الادمن	OBJ
هل تعلم بأن #الشاي يروي الجسم؟ # ? صحة #غرد_بمعلومة …	OBJ
"#حماس" تجدد رفضها الاعتراف بالاحتلال نفي المتحدث باسم حركة المقاومة الإسلامية "حماس" في الخارج، حسام بدران، عزم	OBJ
من قتل اللواء فراج؟ زميله قاصد زميله بالغلط زميله وخلاص	OBJ
هو انا عشان بعمل الصح وبغير من نفسى للأحسن ابقى كده معقده #مجتمع_مريض #حافظ_مش_فاهم :)	NEG
المادة التاسعة وأسباب أخرى لرفض مسودة مبادئ الدستور (1) - عمرو حمزاوي - بوابة الشروق	NEG
"3: وقفة حملة اخوان كاذبون بالزقازيق"	OBJ
ياصاحبى فى رحلتى ياسندى فى شدتى يامؤنسى فى وحدتى ياناصرى إذا إنقطعت حجتى يانورى فى ظلمتى يا أملى فى كربتى لاتتركنى	OBJ
الإعلامي والمتخصص في الشئون التركية #نشأت_الديهي ضيف #يوسف_الحسيني في #السادة_المحترمون علي # …	OBJ
الصحة المصرية نتابع القادمين من السعودية ولامخاوف من كورونا #مصر #القاهرة #أخبار_دولية	OBJ
إنها المرجعية الاسلامية العظيمة، التى تحتاج إلى من يبحث فيها، ويستخرج كنوزها، ويعمل بمقتضاها، أما الأشخاص، فهم زائلون، والمرجعية باقية	OBJ
مرة جماعة اتبهدلت من عبد الناصر جم عملوا إيه بالظبط #تاتاراراتتت	NEG
سأكون معكم الآن على المنتدى لمناقشة ما جاء في الحلقة السادسة من برنامج قصة الأندلس	OBJ
إيه خبر القبض على جون ستيوارت ده؟ حصل فعلاً؟	OBJ
وكم من #أب سيحصل على #حزام بعد #الامتحانات :) :)	OBJ
تحركات مابراهيم محلب في افريقيا #في_حاجة_صح	OBJ
الأمن مستقر بـ #جنوب سيناءوتأمين كامل للقناة	OBJ
أكد مراسل قناة سكاي نيوزالإخبارية، إنه تم القبض على رجل الأعمال الإخواني حسن مالك	OBJ
الانقلاب كشف الحرب القذرة على احرار الالتراس الاعلام الفاسد يدعم مشروع تصفية احرار الالتراس	OBJ
ياريت البلتاجي اللي بيتمسح بشركاء الثورة الآن يفتكر إن اللي باع شركاء الثورة هما الإخوان من أول استفتاء مارس ولغاية مليونية جامعة القاهرة	OBJ
انا لو خلفت ولد هسمية #عبد #الفتاح :) اهو لو مطلعش #مشير يطلع #عنتيل :) :)	OBJ
14 مليار #شيكل ديون #السلطة للكهرباء #الإسرائيلية	OBJ
كلنا نثق في الجيش المصري ومن أجل ثقتنا واعتزازنا به نريده أن يرجع إلى ثكناته ولا يزج به في حسابات سياسية ضيقة	OBJ
د علاء الأسواني: ما سر لهوجة المجلس العسكري السابق ؟! أقرأ المقال كاملاً على هذا الرابظ : … …	OBJ
غيّرت موقفي من حزب #النور بسبب مواقفه المخزية مع الرّئيس #محمد_مرسي ووقوفه مع …	OBJ
د/ الجنزوري يتميز بسمات إيجابية وسياسية جيدة ولكنه محمل بأثقال الماضي الذي ثار عليه المصريين	OBJ
#فلسطين| مصلحة السجون الاسرائيلية تعزل و تنقل أكثر من 100 معتقل اداري فلسطيني بعد أن أعلنوا إضرابهم عن الطعام منذ 4 أيام…	OBJ
نخلص من #دينا_الوديدي ندخل علي #دنيا_مسعود مش عارف فيه ايه النهاردة يوم جميل ويا بختوا	OBJ
علاء الأسسواني: ان جماعة الاخوان المسلمين تقوم على السمع والطاعة العمياء والولاء المذل الى درجة تلبيس الأحذية >>	OBJ
#الوفد - #ﺍﻟﻌﻠﻴﺎ_ﻟﻼﻧﺘﺨﺎﺑﺎﺕ: ﺃﻭﺭﺍﻕ #ﺍﻟﺴﻴﺴﻲ ﻭ #ﺻﺒﺎﺣﻰ ﺻﺤﻴﺤﺔ	OBJ
الفلوس تشترى النفوس اصحاب الرواتب والملايين يؤيدون الانقلاب وكل البسطاء ومتوسطى الحال والشرفاء يرفضونه	OBJ
وآنا علي يقين بقا أن كل سلطة ف مصر من أول الفراعنة لحد دلوقتي ، سلطة متخلفة وعلي رأسها حمقي ، باستثناءات قليلة !! #مبارك #طنطاوي #مرسي #	OBJ
#يوسف_الحسيني يلقي الضوء على محاكمات شباب الاخوان الذين ثبتت براءتهم ويرى ضرورة إلقاء الضوء عليها لمنع الجدل …	OBJ
بوابة الشروق| #صباحي ينفى صحة تسريبات "محاكمة #السيسى" وحملة #المشير: تصرفات "غير مسئولة" #مصر #	OBJ
خطط #خالد_بن_الوليد الحربية	OBJ
د عبد المنعم ابو الفتوح فى حلقة قناة التحرير السبت الماضى عنده سؤال من محمود سعد على موقفه من الجمعة 8 يوليو:	OBJ
بسمة أمل - خلى خيرك لكل الناس --------------------------------------------- يروي لي أسامه و هو شاب سوري	POS
"_: #معرض_الكتاب كتاب : المشوق إلى القراءة وطلب العلم لـ الشيخ _ "	POS
اهم تعاقدات الانديه ! #ارسنال اوزيل #تشيلسي ماتيتش، شورليه، ويليان #مانشستر_سيتي نيقريدو، يوفيتتش، فيرناندينو #ليفربول اسباس ، موزيس ساكو !!	OBJ
بحبكوا ٥ إمواه  #فيفي_عبده #نبيلة_عبيد #حبيبتشي #حبيباتشي #واتشيه #واتشية	OBJ
وزير التعليم يخاطب "الداخلية" للإفراج عن الطالب الفائز بمسابقة "إنتل" #مصر #ميدان_التحرير	OBJ
من أسباب نجاح مسابقة #تدوين (2/3) التفاعل الكبير من المغردين أنفسهم بالقيام بترشيح من استفادوا منه بالفعل من معلومات وأف…	OBJ
شبح اضطرابات عشية التصديق على عشرات الإعدامات | الأخبار #مصر #القاهرة #محمد…	POS
ماعلمك صوت المطر كيف احتريك #مطر	OBJ
وقد أحرز يسري فودة هدفين من ضربتي جزاء اصطنعهما بنفسه	OBJ
#نفسك_فى_أية_فى_الجنة_ نفسي إنه نفسي "تهدأ"	OBJ
_ بعض أحيان إصبع واحد يكفي :)	OBJ
بالصور أنصار #مبارك يهنئونه بتحرير سيناء من أمام "العسكري" والمخلوع يلوح لهم بيده …	OBJ
#عمال #مترو أنفاق #لندن يعتزمون الإضراب ليومين بسبب تخفيضات مزمعة في الوظائف #سكاي_نيوز_عربية	OBJ
دعلاء الأسواني: لماذا يتحرش المصريون بالنساء ؟! أقرأ المقال كاملاً ؟! >> … …	POS
نسيت أقولك إنك لو مؤمن بعدل ربنا لازم تطلع مبارك من السجن أو تحصله لأنك مسئول سياسيا عن قتل مواطنين مصريينبلوك وريبورت سبام	NEG
وكله كوم والتعليقات بتاعة الفيسبوك اللي تلاقي فيها واحد بينه وبين إسراء بتاع 8 سنين ويقول لي:"إزيك ياض يا وائل" ياض؟ جيل أساحبي صحيح :)	OBJ
أبو الهول ومن خلفه أهرامات #الجيزة عام 1875 م	OBJ
لو كان #شفيق كسب كان زماننا لحد دلوقتي فاكرين ان #الاخوان فصيل وطني بيحب #مصر عسى ان تكرهوا شيئآ وهو خيرآ لك…	OBJ
يوسف الحسينى وتفاصيل مقابلتة بالرئيس عبر تويتر الان عن الببلاوى	OBJ
فى ذكرى تحرير "#سيناء"خبراء: "#كامب_ديفيد" أضرت بـ #مصر لصالح #إسرائيل والسياج الحدودي عديم الفائدة بدون غطاء ناري	OBJ
الرئيس مرسي المسئول الاول عن حقوق المصريين وكرامتهم اما ان يوقف الرئيس الخطف والضرب والتعذيب والمحاكمات العسكرية للمدنيين واما ان يرحل	NEUTRAL
أخشى من أن يشوه بعض من يتكلمون باسم المشروع الاسلامي أن يشوهوا المشروع د عبد المنعم أبو الفتوح أثناء لقائه	POS
فيديو : د عبد المنعم أبو الفتوح فى حلقة القاهرة اليوم الثلاثاء 16 أغسطس 2011	NEUTRAL
مرسي: أحيي السويس الباسلة وبور سعيد الصامدة وهاقول لهم هانيمكو من المغرب	NEG
شــايــف طريقـى اخره نــور و مش انــا اللى اعيـش مكســور و لو ماوصلتش برضو عادى هاعيــش حيــاتــى و هافضــل راضــى #كاريوكى #من_الروائع	NEG
#المجد_للمبتسمين_صباحا #صباح_الخير	OBJ
7 #1فاضي #صباح_الخير #بعد_منتصف_الليل #غرد_بذكر_الله #صور_كنك_بنت	OBJ
الشريف حسين أمير المغفلين #الحجاز #سقوط_الخلافة #الخلافة_العثمانية #مصر #مكة	OBJ
ما هي الهوية المصرية اللي مكتوبة في دستور الجماعة؟ وهل لها علاقة بإطلاق اللحية وحف الشارب؟	OBJ
#اكتب_رساله_لشخص_دون_ذكر_اسمه الحياة ي صاحبي أجمل من بشاعة الحزن لا تحزن ابتسم وتفائل دائما ، وكن على يقين لن يصيبنا إلا ما كتبه الله لنا	OBJ
عمرو موسي وسامح عاشور ومنى ذو الفقار فى صدارة لجنة الدستور البقاء لله فى ثورة 25 يناير	NEG
:) :) #هاشتاج #صاحب_يتصاحب تابعونا وكمان تقدروا ع صفحتنا ع فيس بوك وتويتر تشاركونا ومن رابط الاستماع فى أول	NEG
_ مبروووووووووووووووووك للريال حببتى بس الصراحة البايرن هوالى كان احسن #ذا_شامبيووونز	NEG
تأسيس نقابة الفلاحين بعد الثورة خطوة على طريق نضال طويل من أجل استعادة حقوق وكرامة الفلاحكل عام وفلاحى مصر أقدرعلى القيام بدورهم فى النهضة	NEUTRAL
#ربنا نسألك رضاااا ك و الجنة و نعوذ بك #ربنا من سخطك و من عذاب النار #اللهم_آمين	OBJ
اعرف بلادك - المغرب عين أسردون - توجد في بني ملال وهي مدينة مغربية تقع في الوسط الغربي للمملكة المغربية وسهل	POS
__7 شوف انا لا اخضع للمزايدات و لا تفرق معايا القصص دي،صوتي لا يعبر الا عن قناعاتيو من الآخر 90?من المزايدين لم يتعرضوا لما	OBJ
ندوة د عمرو حمزاوي بجامعة المنصورة الجزء الثانى	OBJ
_ ده بس من ذوقك	OBJ
اردوغان عمد إلى دغدغة مشاعر العرب بخطابه عن القضية الفلسطينية #السادة_المحترمون	OBJ
عبد المنعم أبو الفتوح فى الجزيرة مباشر مصر	OBJ
العنف بمحاصرة مؤسسات السلطة القضائية وتعويق عملها لإخضاعها لإرادة الديكتاتور الذي يضع نفسه وجماعته فوق الدولة والسلطات والمؤسسات - مصر 2012	OBJ
احمد رجب ومصطفي حسين باقيان على قيد الحياة بالجسم والمال لكن البقاء لله فى القيمة والقامة والكرامة	OBJ
، وصلت بك البجاحة والفجاجة والاجرام اتهامك للشرفاء بانهم هم القاتلون وانت وانت البرىء اسكت ايها القاتل 3	OBJ
التوزيع اللوجستي للخدمات الطبية والاسعاف مطلب هام لحماية الأرواح !! #الامارات # وزارة_الصحة # وزارة _ الداخلية	OBJ
حملة امنية لكلاب #الداخلية مكونة من ﻣﺪﺭﻋﺘﻴﻴﻦ ﺟﻴﺶ 3 ﺑﻮﻛسات شرطة ﻋﻨﺪ ﻛﻠﻴﺔ هندسة المطرية #عين_شمس #بلغ #ريتويت	OBJ
شاهد - آخر كلام: ماذا لو قضي بعدم دستورية الانتخابات #	OBJ
"_: السماح بعبور أهالى #سيناء من كوبرى السلام خلال ساعات حظر التجوال بمدن القناة "	OBJ
صح !	OBJ
شكوك حول مشاركة #جدو أمام #الدفاع بـ #المغرب #الأهلي #الكونفدراليه	OBJ
رأي الجاحظ في نفي الوحدة العرقية للعرب، وأن العروبة موطن ولغة وثقافة #اليوم_العالمي_للغة_العربية	OBJ
السلطة تمارس إجراما سياسيا ضد الفقراء	NEG
اختلافنا مع الموقعين علي البيان سياسي ولانخونهم #" _ # #	OBJ
13 "جولة ميدانية مدينة نصر - الحي العاشر"	OBJ
#دعوه_للتفاؤل هاشتاق جا بوقته *-*	OBJ
من يريد ان يقدم لوطنة سىء لا ينشغل بالدفاع أو إيذاء الآخرين أبو الفتوح يتحدث الآن #	NEG
انهيار اقتصادى شنيع وانهيارات امنية وسياسية واعلامية غير مسبوقة مصر لن تجد طعاما وشرابا لشعبها خلال شهور اذا استمر الانقلاب	OBJ
أين الدولة من ملف الاحتجاجات العمالية المستمرة في التصاعد على خلفية سياسات أجور غير عادلة ومظالم تراكمت طوال العقود الماضية دون حلول جذرية؟	OBJ
جامع ايمينينو في #اسطنبول #تركيا_بعيون_عربية #تركيا #طرابزون #السعودية	OBJ
_ أسد فالبرلمان ياسيادة النائبوالحق معاك عمره مايضيعاحنا وراك من مصرى مغترب فالكويتعضو حزب الوسط	OBJ
فارق ضخم بين تطلع الشعب لحكم قوي والإلتفاف حول اسم بعد كل هذا،وبين ان يظن البعض ان السيسي سيرشح نفسه رئيسا،هو يرى صوره ولكنه لن يفعلها #مصر	OBJ
عرض الاسبوع 10 ألاف متابع #درر #حكم #حكمه #حكمة #ابيات #النصر #الهلال #الفتح #كلمات #كلمة #بوح #الاتحاد [2290794]	OBJ
_70007 الحمارة امك #فطيم_النعاشة وانت ولدها و اذا فكرت تصير ولد حلال اطلب من #فيفي_عبده_الام_المثالية تتبناك هههههههه …	NEG
الدكتور الأسواني يهتم جداً بقراءة كل ما يصله من القراء سواء كان نقدا إيجابيا او سلبيا الا الشتائم فانا ازيل قذارتها اولا باول ميشيل الادمن	NEG
خمس الاف #الامارات #الهلال #النصر #السعودية #الكويت #قطر #الرياض #مكة #رتويت # #دبي #الشارقة # #غرد_بصورة 144	OBJ
د علاء الأسواني: ماذا يريد أنصار الأخوان من اسكندر طوس ؟! >> أقرأ المقال كاملاً على هذا الرابط : … …	POS
و بعدين بقى امن الدولة تتعاطف معاه الناس و يكسب الانتخابات ويسيطر على التأسيسية وينزل التحريروصفوت حجازي يبوس ايده هناك	OBJ
صح وعارف انه لا بكاء على دم الارهابي اومن يمارس عملا عدائيا تجاه الوطن او اقترف عملا من اعمال العدو ومصريتنا ليس رقم قومي وحسب	NEUTRAL
اتابع بسعادة واعجاب مئات المغردين الشجعان اسلوب شيق وخفة دم ورؤية ناضجة واستنتاجات مذهلة مواهب مصر كثيرة يدفنها الفساد والواسطة واللصوصية	NEG
إعادة ضبط بوصلة الذات السياسية (١) - بوابة الشروق ::	OBJ
الكابوس: حوار أتمنى أن يقرأه بهدوء ويفكر فيه كل الذين يرفعون شعار افرم يا سيسي اضرب يا سيسي	OBJ
من لا يعرف أمه إلا يوما في السنة فهو عاق لها، ومن يصلها ويهديها ويبرها كل يوم فلا معنى لـ #عيد_الأم عنده، فعيد الأم من…	NEG
"مرحاض" مصطفى بكرى في جريدة الوطن: "طنطاوى قال لى: "العسكرى" كان مجتمعاً لمتابعة نتيجة الرئاسة ودخلت الحمام فخرجت لأجد مرسى رئيساً"	NEG
ايه اكتر اغنيه عجبتكم من الفنانه #غادة_رجب في برنامج #احلي_مسا مع النجمه #فيفي_عبده و النجم #هشام_عباس ؟	NEG
كنت كتبت كلام كتير اوي وف الاخر كله ماشيمسحت كل حاجه و سيبت كله ماشي #كله_ماشي	OBJ
موعدكم اليوم الاثنين الموافق 28 إبريل ب #أنوار_رسالة #المعادى مع محاضرة جديدة من كورس " " مع المدربة	OBJ
برنامج امريكا بالعربي - الحلقه 5 كاملة	NEG
يا شباب أهدى لكم قصة الحب هذه و حلقة جديدة من بسمة أمل - الحب الحقيقي لا يموت	OBJ
آااه، إف إف يعني فولو فرايداي! و مين "جمعة" ده اللي عايزنا كلنا نمشي وراه؟	OBJ
الشيخ حافظ سلامة يؤكد فشل مؤامرة أمريكا لإسقاط الجيش المصري #السادة_المحترمون	NEG
لايمكن ان نصل الى الديمقراطية بدون قانون يمنع الدعاية السياسية في اماكن العبادة	OBJ
ما أتعس الدنيا إذا صرنا مع الأيام شيئاً في الطريق ! #فاروق جويده	OBJ
ماذا تغير؟ أسئلة إلى قيادات جماعة الإخوان المسلمين:	OBJ
اشاعةمن اشاعات الفيس بوك	NEG
العرس ما ريدتوة ولا المكان حبيتوة بس الحليب هطأ بنهودي و ان يسألوكم مين أبوة قولو دة خدها غضب #دينا_الوديدي #مريم_صالح :))	NEG
48670715 _ من سنة 92 بدأت الكتابة ضد إستبداد مبارك وضد التطرف الديني أيضا وماكانتش لسه المعارضة رخيصة وبتلم	NEG
ماذا رأيتم من موجابى حتى تكرهو دستوره (أخوان ستايل )	OBJ
كله ينزل بكره مكان ما نزل يوم 30-6متخلوش اللي بيحصل يخوفكم--نزولنا بكره هو اللي هيخلص الموضوع	OBJ
_ مستقبل ايه اللي مستنينه في دولة الظلم و الاعدام و مصادرة الحريات #سنحيا_كراما غصبا عن المتخاذلين	OBJ
_ التقرير الشهري للمشافي #السوريه التي تسلمت دعم من مكتب الدعم الدوائي(مدد) في شهر #مارس 2014 #قطر #السعوديه …	OBJ
مجلس الوزراء و محمد محمود اتحسبوا رسمي شهداء ثورة و صرف لهم تعويضات هزلية، ماسبيرو رفعت قضية باسمي لاحتساب…	OBJ
حلقة الليلة الجزء الاول	OBJ
فرق بين مبادرة اتنمية الوعي وبين استعمالها كحل لفشل الدولة التي ندفع لها الضرائب	OBJ
عرض الاسبوع 10 ألاف متابع #السعودية #أبناء_الدم #ليش_لا #البحرين #غرد_بصورة #المنامة #الدوحة #الرياض [2405311]	OBJ
فن مكافحة الغائط!	OBJ
اخوان ملثمون بأسلحة الية وسط ميدان رمسيس -	OBJ
أن أحاول أن أسامح من أساء إلي ليس من أجله أو من أجل صحتي النفسية والعقلية بل من أجل أجر عظيم أعد للعافين عن الناس #علم…	OBJ
#كريستيانو_رونالدو بين الأكثر تأثيرا في العالم بقائمة "تايم"! التقرير:	NEG
إذا جعلك والديك أميراً مدللاً في صغرك فاجعلهما ملوكاً متوجة في كبرك	NEG
مصرىأولا و قبطي فخور و انت إيه و مين؟	OBJ
"لبيب": لا نية لدى #الحكومة لزيادة #الأسعار	OBJ
مش مهم يكون عندي فولورز كتير المهم اسخف على	OBJ
#صباح_الخير #بعد_منتصف_الليل #غرد_بذكر_الله #صور_كنك_بنت #لو_كنت_المتحكم_بالتويتر #رتويت خمس الاف بـ 200 ريال 5	OBJ
الشيخ كشك وجلاد السجن الحربي حمزة البسيوني الذي قال لو نزل الله من السماء لحبسته في زنزانه #مصر_القوية	OBJ
اليوم هو ثاني أيام الوفد المصري الشعبي في أوغندا و دولة أوغندا يبلغ عدد سكانها 25 مليون نسمة، وتعتبر أقوى دولة	OBJ
ياجماعه هو انا غلط لما احترم واؤيد #ابوالفتوح و #البرادعى ؟ هو انا كده مجنون ؟ هو انا لازم اشتم واحد فى الاتنين	OBJ
بلاغ وهمي عن #سيارة_مفخخة يثير الذعر في #شبرا_الخيمة	OBJ
#السادة_المحترمون الحلقة 114 الأحد 11 أغسطس 2013"عخالد عكاشة،حسن الرداد،حورية فرغلي" #مصر …	OBJ
لما شهاب يقول لنواب الوطني: "وأنتم الأعلوْن" يبقى إحنا إيه؟ الأسفلوْن؟ واللا يمكن إحنا كفار قريش طب والنصارى و سيئ بدوي يروحوا فين؟	OBJ
البرنامج - الحلقة 12 كامله:	NEG
أنت شخصية عامة ياأخي الكريم لابد أن تتقبل النقد الساخر كما نتقبل نحن التكفير والتخوين من مشايخكم وأنصاركمغفر الله لنا ولك	OBJ
الامتحانات هتخلص بـ سرعه الصوت يعني مثلاً نقول #ابو_الفتوح ، اهو فـ آوح ديه تكون الامتحانات خلصت #تصبيرة	OBJ
فريق عمل يشارك قوات الأمن في اقتحام دلجا …	OBJ
الرياض #القصيم #واحد_فاضي #الهلال #السعودية #النصر #النصر_الهلال #البدائع #الزلفي #حفرالباطن #مكة #جدة [2635558]	NEG
#حركة_كايدينهم الإصابة تُبعد آزارينكا عن بطولتي مدريد وروما: لن تشارك المصنفة الرابعة على العالم ف #بلدنا	OBJ
مع انى مليش صوت انتخابى بس بردة سندعم قائدنا#سأنتخب_السيسي #تحيا_مصر	OBJ
{ اللهم ارزق امي الجنة فانها جعلت حياتي جنة } #غرد_بالخير #دعاء	OBJ
لكن الكاهن #القرضاوى في عام 1999 يدعوا في فتواه الخوارج في #الشيشان ممن اسماهم " بالمتطرفين "	OBJ
حكومة الجنزوري استلمته 37مليار وسلمته 17 حكومة قنديل استلمته 17 وسلمته 19 حكومة الزبلاوي استلمته 19 والي…	OBJ
الحمد لله بسمة قامت بالسلامة، وربنا رزقنا بنادية	NEG
أخبار تل أبيض || اتحاد تنسيقيات شباب الكورد في سوريا - تنسيقية الرقة - تحذير و نداء #هام جداُ - داعش	NEG
زنزانه 4 عنبر (أ) سجن الحضرة بقلم دعمرو عاطف واحنا لسه تافهيين #أنا_مش_رقم	OBJ
الحلقة 27 - الجزء الأول - الزغلول الكبير	OBJ
#زمكان - #مصر |#أخبار_مراسلينا | ابراهيم #حماد يمنع استخدام عربيات ربع النقل فى نقل الركاب فى #اسيوط اسيوط -	POS
صبحي صالح: حكم "الدستورية" بحل البرلمان "جناية تزوير" وسنرفع دعوى ضدها يا سلام	OBJ
771 وثقوا فيهم؟ وهو اللي يثق فيك تخونه وتقول شرعية؟ انت مصدق نفسك؟	OBJ
كفالة اليتيم #صورة #اليتيم  #نشر_سيرته #	OBJ
أحل ضيفاً على رولا خرسا في قناة الحياة الليلة الساعة 10:30 بتوقيت القاهرة	OBJ
#حركة_كايدينهم هوا ليه صباع رجلى موش زى صباع ايدى حد يقولىىىىىىىىىىىىىىىىىىىىىىىىىىىىىىىىىىىىىىىىىىىىىىىىىى …	OBJ
الانتخابات البرلمانية القادمة محطة كبرى، فإما تقارب بيننا وبين الدولة المدنية بمعانيها غير العسكرية وغير الدينية أو تباعد بيننا وبينها	POS
# بالصور أنصار مرسي يحرقون كنيسة ومدرعة للجيش بالسويس	POS
دستور لا يمر بموافقة ثلثين الشعب على الأقل وفقط بالأغلبية المطلقة يبشر بإنقسام الوطن والإطاحة بالإستقرار ولن يعمر	POS
قال شو خبر عن مستثمر #أردني في #اليمن يواجه الموت المحتم في إحدى #السجون في #اليمن ،، ياباااا اذا	OBJ
#مرتضي_منصور يهاجم #ميدو و #ابراهيم	OBJ
قلتلك ايه على الناس اللي بتشتم؟	OBJ
طالب المجلس العسكرى على وجه السرعة بتوضيح الحقائق و أولها أسباب و ملابسات إستخدام العنف و إتخاذ الإجراءات الضرورية لإنهائه	OBJ
حان الان وقت صلاه الفجر لــ #نيويورك #امريكا 4:33 ,	OBJ
مش دستورنا و دى بلدنا	OBJ
البيض والطماطم نفذت فى دلجا الاهالى اشتروها انتظارا لوصول صباحى واتباعه	NEG
#خليك_مصدق أقوى هاشتاق مصري كأنك تستمع لتلفزيون #مصر الذي سطا عليه الانقلابيون، أو كراخانات عكاشة وأديب والابراشيو…	OBJ
دأبو الفتوح : مدير كل مستشفى ومدرسة ومكتية ومؤسسة يجب أن يدرك ان الخدمة التى يقدمها للمواطني يجب أن يسهل حصول	OBJ
من فاعلية حركة #نساء_ضد_الانقلاب بـ #دمنهور صباح 30 4 2014 #مكملين #انتفاضة_السجون # …	OBJ
من يحكم مصر يجب أن يكون متصالح مع الدين مسلما ومسيحيا فهذا طبيعة المجتمع المصري الذي يقدس دينه د عبد المنعم أبو الفتوح في مؤتمر بأسوان	OBJ
من سنن التي تفعل في السجود مجافاة ( ابعاد )فخذيه عن ساقيه #نشر_سيرته #	OBJ
الآن: أ حمدين صباحي بعد إعلانه نيته الترشح للرئاسة في آخر كلام على 12053 - 12398 #	OBJ
لكل الذين يحاولون إيجادمبررات لحركة المحافظين،لأوضاع الأمنية مسؤولية مديرين الامن لا المحافظين، أما المحافظات الحدودية فلها وضعية خاصة #مصر	OBJ
كلما تكلم ابو الفتوح عن اضرار الانقلاب على الحريات والاقتصاد والانقسام اتذكر قاتلا ينعى ضحيته منحته صوتى للاسف	OBJ
7 بتقف طبعاً والشركة بتدفع غرامات هو ده الضغط	OBJ
#مجلس_الوزراء ينفي إتخاذ أي قرار بزيادة أسعار السلع #البنزين #نصف_الدنيا :	OBJ
_ ما تتعبش نفسك كل واحد بيدور على اللي هو عايزه بس،حتتشتم من الناحيتين	OBJ
شكراً لـ #الدفاع_المدني لإنقاذ #طفل_طبرجل تذكرت #لمى_الروقي فكر أنا ينسى؟	OBJ
) #جمعية_الاقل_من1000_فولورز	OBJ
المنافسة مسالة طبيعية جانبها السلبى هو تفتيت الاصوات بين القريبين من بعض فى افكارهم	OBJ
الأربعاء : استمع لابو الفتوح اليوم 1030 مساء على إذاعة الشباب والرياضة	OBJ
المتفائل إنسان يرى ضوء غير موجود و المتشائم يرى ضود ولا يصدق	OBJ
حصل مكالمة مبدئية مع وزير التعليم متحدثا عن خطته القادمة لحين لقائه و جاري التنسيق مع البقية	OBJ
محمود سعد الذى أساء لقطر فى زمن مرسي يعترض على قول ضيفه(بنشحت من الى يسوى والى ميسواش) لان من يساعد مصر يستحق	OBJ
الجيش والداخلية والبلطجية ايد واحدة لارتكاب جرائم وحشية جديدة ضد شعب مصر فى تظاهراته السلمية 30 اغسطس الشعب يستعيد ثورته	NEG
كل من يظن انه ربما يكون مرصود الحيطة و الحذر و عدم المبيت في المنزل اليوم #شارك #انشر #حذر	NEG
#مسلسل_منفوخ الهاشتاق اللي سويته صار #ترند !!! شكرا لكم	OBJ
123 معلوماتى انك لا تشرب دايات رغم	OBJ
دكتوراه فخرية فى القانون من كلية ترينيتى العريقه فى دبلن تكريمى هو تكريم لكل مصرى	OBJ
ياشباب الاخوان أنا فعلا حزين لأنكم شباب وطني يدفع بكم مكتب الإرشاد لمواجهة مع الشعب المصري ويجعلكم تدافعون عن رئيس ديكتاتور لا يفي بتعهداته	OBJ
اللهم ارزقنا قلبا خاشعا و لسانا ذاكرا و جسدا على البلاء صابرا آمين	OBJ
لكن أنا مبسوط إنه في احتفال 6 أكتوبر اختفت الشرعية الحربية العسكرية للحكم وحل محلها رئيس مش عسكري جاي بعد معركة	OBJ
قناه الوسط الرسميه عاليوتيوب	OBJ
صلاح جاهين وفؤاد حداد في بروجرام واحد متع روحك ونضفها من خطابات اللجلجةتصبحوا على خير	OBJ
بسمة أمل من سوريا اللهم أعد البسمة على وجوه أهلنا فى سوريا	OBJ
من له مصلحة بتمويل أولئك الفلول الذين حرقوا علم #قطر في ميدان #مصري لم يدخله يومها شريف الا لبيع المناديل والماء او الفرجة على بلاهة الحمقى؟	OBJ
صلوا على الحبيب فى بداية لقاء جديد من لقاءات "على خطى الحبيب" نتحدث فيه عن بناء إنسان النهضة وعن الوضع في سوريا	OBJ
دعبد المنعم أبو الفتوح فى عيون العالم	OBJ
على رأيك جابوا ضرفها	OBJ
‏#لماذا_تخلع_البنت_الحجاب "ضعف الدين تساهل الولي تأثير الصحبة التمرد على الحياء" استنباط الإمام ابن باز …	OBJ
بالفيديو عبد الرحيم علي يكشف تخابر البرادعي مع المخابرات الأمريكية #باسم_طلع_حرامي …	NEUTRAL
اوعوا #الاستفتاء ع #الدستور ينسيكم ان مجدى عبد الغنى جاب جون ف كأس العالم #مصر #	OBJ
الارقام الرسمية لحملة #تمرد بجميع المحافظات	OBJ
" #كاف " يدعو " #شحاتة و #ابو_تريكة" لحضور قرعة #كاس_الامم و #ابطال_افريقيا #مصر #الزمالك	OBJ
هاتوا 4 فولورز كده لحد ما اعمل الشاي #ريتويت #نانا3 #هيلب #انشر #وزع #احشد #خليكوا_حلوين #يقعدلكوا_في_عيالكوا	OBJ
شاهدوا برومو حلقة جديدة من حلقات بسمة أمل أنيماشن - موعدنا في رمضان كل خميس الساعة ٥ مساء كل عام و أنتم بخير	OBJ
كل القادة والصفوة المعتقلين من علماء واطباء ومهندسين ودعاة ومدرسين هم نماذج الخير والحق فى مصر والدنيا	OBJ
"1: شاهد- #فيفي_عبده راقصة سيذكرها التاريخ #1 #الحكم" خبر في الصميم	OBJ
مع اعلام خالتى فرنسا يؤكدون ان فيديو سيسي المسرب مفبرك ثم يؤكدون (هم بشحمهم ولحمهم) ملاحقة من سرب الفيديو	NEG
لبـستُ ثوب الرَّجا والناس قد رقدوا - وَقمتُ أشكو إلى مولاي ما أجدُ / وقلتُ يـا أمَـلي في كلِّ نائـبةٍ - ومَن عليهِ لكـشفِ الـضُّرِّ أعتمدُ	NEG
10 مليارات جنيهاً حجم عمليات تهريب الدقيق المدعم	OBJ
اليوم السابع | كلاب بوليسية لتأمين #امتحانات #عين_شمس و #الجامعة: منع دخول المفصولين	NEG
#غرد_بذكر_الله #اذكر_الله #حصن_المسلم	NEG
#يانبى سلام عليك #ماهر زين	NEG
__ 1 _ يعني انت مش متابع بس بتشتمني احتياطي؟	NEG
# #لغز_الحياة #مصطفي_محمود #البرنس	NEG
#محمد_رمضان و #السبكي: تهاوشوا مع بعض احسن عشان لا نشوفك في افلام زباله	NEG
هذه هي الأيام التي تجعلك تبدأ في التفكير بجدية فيما قاله نيتشه "عندما تحارب الوحوش إحذر ألا تتحول إلى وحش"اللهم لا تفقدنا إنسانيتنا أبدا	NEG
مصر تقرر مراجعة علاقاتها مع الدول التي تستضيف اجتماعات تنظيم الإخوان …	OBJ
#نفسك_فى_أية_فى_الجنة_ أستمتع بصحبة النبي صلى الله عليه وسلم ! ~	OBJ
مشكلة اليسار مش اللي قاله العريان مشكلته إن رغم كونه الفصيل الأكثر فاعلية ونضالية في الثورة المصرية لم يستطع طرح شكل	NEG
لقد صححت الرقم 70 مليار لأني وجدت أن 95 هو القديم إتفضل ولو لقيت حاجة غلط أرجوك بلغني:	OBJ
يـــا #ارق مـــلـــاكـ انـــا #قــلــبـــي مــلــك بـــعـــيــــون اه كـــل #الـــاحـــلـام #عمرو_دياب	OBJ
وجهة نظر من أعصام تليمة تجاه ترشح د عبد المنعم ابو الفتوح	OBJ
و أنا أيضا أين قرأت هذا ؟	OBJ
ايه هو اللي على الجزيرة؟	OBJ
بنتعلم منك يا باشا	OBJ
لن نسمح أن يزج بنا فى حرب أخرى وتدخلنا بـ #سوريا و #أوكرانيا من أجل الحل السلمي#أميركا #العرب	NEG
"_: #عشان_خاطر_ماسر هات البتاعه دي " #انتخبوا_العرص	OBJ
شاهد كلمة الدكتور عمرو خالد في اجتماع الرئاسة بخصوص قضية سد النهضة	OBJ
أحمد مطر #رابعة #رابعة_العدوية #مجزرة_رابعة #مجزرة_السيسي #مصر	NEG
لا قتل الناس في بورسعيد برصاص الشرطة ولا تعذيب المعتقلين ولا الغاء القانون لصالح مرسي في الاعلان الدستوري لا شيء اقلق أمريكا مثل محاكمة مرسي	NEG
3 الدم المصري كله حرام، أدين الاعتداءات على مقار الإخوان والحرية والعدالة وكافة أشكال العنف، جميع الضحايا مصريون لا فرق بين إخواني وآخر	NEG
#ولاد_البلد #المنصورة #مصراوي تجمهر أهالي القتيل أمام مستشفى #طلخا المركزي، ومديرية الأمن تدفع بتشكيلات أمن	OBJ
الببلاوي: تصنيف الإخوان تنظيما إرهابيا قرار سياسي #الببلاوي #مصر	POS
#هلا_فبراير #الكويت	OBJ
خش اقرا الفاتحة :) #رغيف_عيش_ب40 #كشرى #عم_محمد #ماسبيرو	OBJ
_ من لوعه الحرمان فيك #كفاية	OBJ
قلت للرئيس تم فرض رؤساء تحرير جدد على الصحف القومية بواسطة مسابقة غامضة أجراهامجلس الشوري النتيجة منع المقالات التى تهاجم الاخوان من النشر	OBJ
3 الدكتور لم يقل هذا هو دعا لفصل العمل الحزبي عن العمل الدعوى بمعنى ألا تقوم الاحزاب بممارسات تنافسية في المساجد	OBJ
#مصر_العربية |اقتصاد| السعر الرسمي للعملات العربية والأجنبية اليوم 21 ابريل 2014 م	OBJ
الانقلابي ضيف الجزيرة المدعو محمود عطية يقول امس ان مصر طبيعية بلا اى ازمات نسخة مرتضى بلا سب	OBJ
التويتة السابقة:ايوه العريان قال كل ده مابين جرايد و احاديث صحفية,بطلوا تقرفونا بالبرادعي بقى	NEG
الجزء الثانى من مقال دكتور هشام الحمامى حول ترشح دعبد المنعم ابو الفتوح	OBJ
وزارة كفاءات مستقلةونائب عام جديدولجنة لقانون الإنتخابات :مطالب شعبية وبديهية لحلحلة الأزمة التي تشل البلادمن أين يأتي العناد وغياب الرؤية؟	OBJ
#كلمتين_وبس أحبك جدآ #الى_احدهم	POS
د أبو الفتوح مع متطوعي الحملة هناك إعلام مغرض يضخم حالة الانفلات الأمني لإخافة السائحين	OBJ
أنا فيروس الفيروس :)	OBJ
يوسف الحسيني ضياء رشوان #السادة_المحترمون تابعونا	OBJ
نجمة #ستار_اكاديمي #ماريتا_أبي_نادر وأدائها لأغنية سونة للفنانة شادية #رنا_سماحة_أجمل_سنين_عمرنا # …	OBJ
_ و #مبارك لسة بيتصور بالترينيج سوت	OBJ
ألقاكم بعد ربع ساعة من الأن في برنامج (الحياة اليوم) على قناة الحياة، للحديث عن قضية الإساءة لرسولنا الكريم، صلى الله عليه وسلم	POS
المستشار احمد مكي احد القضاة العظام الذين وقفوا امام مبارك من اجل استقلال القضاء وأمامه معركة صعبة لان الفلول سيتكتلون ضده من اجل مصالحهم	OBJ
ومازال القمع مستمراً بالقانون وبالقوة ! ولكن لا ننسى أن الظلم والتعذيب من محركات الثورة ولتحذروا موجة الغضب	OBJ
امثال #حازم_عبد_العظيم ده نعمل فيه ايه	OBJ
ما اجملها من كلمه لو فهمناها ،، #لن_يضيعنا :) #أحبك_ربي 3	OBJ
#على_الحجار الليلة مع #محمود_سعد :) 8:00 مساءً على #النهار	OBJ
2 واحد قاللي ما صدقتش وبحثت بكل الطرق وفعلا ما لقيتش ولو لقيت أرجوك تقوللي لأني مازلت مخطوف بالمعلومة	OBJ
سي بي سي: جنايات #القاهرة تستمع لمرافعة الدفاع عن المتهم أحمد رمزى مدير الأمن المركزي الأسبق بقضية قتل المتظاهرين بثورة #يناير #	OBJ
غطي الورق غطي بالدمع يا عنيا #كايروكي #	OBJ
الدكتور عبد المنعم أبو الفتوح على الحياة2:أزمة المسيحين في مصر هي الإقصاء وعدم المساواة,وهذا منافٍ للعدل وللإسلام	OBJ
اردوجان هائج اتهم البرادعي بانه خسر الانتخابات مع انه لم يدخلها واتهم الثورة بانها انقلاب يكذب كانه مرشد الاخوانتركيا تحتاج الى حملة تمرد	OBJ
غدا في الثامنة والنصف صباحا وكل ثلاثاء، ألتقي مستمعي إذاعة الشباب والرياضة بمصر مع الإعلامي أحمد درويش في برنامج "هانبني بكرة"	OBJ
برومو حلقة (بائع الليمون) - ثاني حلقات الأنيميشن من برنامج بسمة أمل انتظروا الحلقة الساعة 7 مساء الخميس	NEG
اعتذر عن الألفاظ الفاحشة في التويتةالسابقة لكنها نموذج لمئات الرسائل التى أتلقاها من الاخوان هذه أخلاقهم ومن عجب انهم يتحدثون باسم الدين	OBJ
للثورة جولة اخرى قريبة جداً وساذكركم بإذن الله شعبنا عجوز حكيم يصبر و يمهل الظالمين ثم يثور فنكتشف انه أوعى واعمق واشجع بكثير مما يبدو	OBJ
الآن د ضياء رشوان ضيف آخر كلام على الهواء فقط على 12398 -	OBJ
حرب الغاز تحقيق استقصائي يثبت تهاون مصر في ترسيم حدودها البحرية بما يحفظ أمنها و ثرواتها، آخر كلام، أون تي في، 11م	OBJ
يارب انا مش طالب كتير انا عايز واحده فى خفة دم #رنوش وجنان #سوكا وجمال #شيرى_عادل ورقة #جنات واى حاجة من #صافيناز ^_^ #	POS
هزة وسط "#صافيناز" بـ 110 آلاف جنيه يلعن ابو التعليم	NEG
تاريخ1948 دا بيفكرك بحاجة ؟ يعنى الخيانة قبل #كامب_ديفيد بكتير بعتوا فلسطين فى 48 ياكفره !	OBJ
#نبض_الاخوان ا #عصام_سلطان و ثبات على المبدأ احنا مش حانقدم أى تنازل ومش حانعترف وحانتحبس مش مهم كل	POS
علاء الاسواني: ماذا نفعل لكى نقدم صورة جيدة محترمة عن العرب والمسلمين في العالم؟! الاجابة تتلخص في الأفكار التالية :	OBJ
#انقلاب_مصر #الفيوم|25-4-2014 #حاميها_حراميها	NEUTRAL
لمـا حـد يـبـعـد عــنــك مــتـزعـلــش!!! افـكــر امــك وهـى بـتـقـولـك #ربنا يـبـعـد عـنــك #ولاد_الحــــــرام #	OBJ
هذا الإعلان لصالح مجموعة وسيعرض بالفواصل في رمضان ان شاء الله صوره من الإعلان # #رمضان	NEUTRAL
#القمة_الحكومية #منظر_لن_نراه_إلا_في_الإمارات عائلة واحدة في بيت واحد	OBJ
كيف تصنع ديكتاتور؟ 1 انقلاب 2 تسلم الايادى 3 كمل جميلك 4 رئيس مدى الحياة 5 الله وهب مصر الزعيم	OBJ
القاضى كريم اسماعيل	NEG
بالفيديو مصور ببانوراما #أكتوبر يحقق حلم الزوار بالتصوير مع #السيسى	OBJ
يلتقى د عمرو خالد معكم يوم الخميس القادم باذن الله بمسجد المجمع الإسلامى بالشيخ زايد بعد صلاة العشاء و لقاء جديد	OBJ
حق الصوت عصام-سلطان/137923242939959	OBJ
اسرائيل تطالب الغرب بغض النظر عن جرائم سيسي مع شعبه لمنع الاسلاميين من لحكم, طب ما ييجى نتنياهو يحكمنا	OBJ
الندوة الأسبوعية للدكتور علاء الأسواني بالأسكندرية الخميس القادم السابعة مساءً بأتيليه الأسكندرية التفاصيل >>	OBJ
#تعطل_الواتساب #توقف_الواتساب #الواتساب_معلق تأملو هكذا	OBJ
الحل السياسي يهدف للبدء في بناء الاقتصاد ولا يعني التصالح مع من تورطوا في عنف #السادة_المحترمون …	POS
حلقة الليلة الجزء الثاني: على هامش الرئاسة	OBJ
فى حالة صدور قرار بحل حزب النور ، سيتحفظ الحزب على القرار وبعد شوية كلام وكلام #السادة_المحترمون …	OBJ
1 أدعو كلاً من : الدكتور / محمد مرسى والأستاذ / حمدين صباحى والدكتور / عبد المنعم أبو الفتوح، للحضور لمجلس الشعب المصرى غداً الأحد 3/6/2012	OBJ
من ذكريات صفحتنا || 26 يوليو 2011	OBJ
#الشروق انفجار بجوار مركز مدينة بنغازي يتسبب في أضرار بعدد من السيارات: وقع انفجار كبير في ساعة مبكرة #مصر	OBJ
الرأى والتعبير فى خطر !	OBJ
بسمة أمل - خواطر من داخل حلبة مصارعة الثيران	OBJ
#جمال #خيال #حقيقه #جميل #درر #حكم #أعجبني #حكمه #بقلمي #شوق #بوح #شعر #قصيد #رتويت خمس الاف متابع بـ 200 ريال 157	OBJ
#حفاية_بلاستك #كبدة_جاج #بيوستات #الدنيا_شوب #حبة #لاب_بروسثو #بطيخ #وسط_البلد #بطانية #هديه #ملعقة_خشب #كنباية #لمبة #زرا…	OBJ
استغربكم ياآل المنتصف حينمالم تصدقوا #مرسي حينماقال"…	OBJ
أنصار الإخوان فرحانين قوي بلبانة إحنا لو نزلنا الشوارع هنربيكو وفاهمين إنهم لو نزلوا وعملوا موقعة جمل جديدة وقتلوا كل الناس إنها هتخلص	NEG
#العربي_الجديد | #سياسة | #فلسطين | اعتداءات #الأقصى: التحقيق مع مصلين فلسطينيين	OBJ
يدعو إلى نصرة مسلمي #الروهنجيا في جامعة أمريكية #بورما #أراكان #ميانمار	OBJ
الوطن | العصف بالحرية على إيقاع ممارسات مبارك | عمرو حمزاوي:	OBJ
#اول_مره_ادخل_تويتر اتقفلت منو و فضلت سنة مفتحوش و كنت مقتنع انه غبى !!	OBJ
شبكة سوريــ المجد ــا || || =-=-=-=-=-=-=-=-= #هام بالـ #فيديو اعترافات المهندس رياض …	OBJ
قرية #الرشايدة مركز #العسيرات محافظة #سوهاج : إصابة 11 فى مشاجرة بين عائلت #	OBJ
ارجو من مذيعي وضيوف الجزيرة الرد على حسام فودة عندما يكرر عبارته اليومية ما هى صفة خيرت الشاطر ليلتقي سفيرة	NEG
من فضل الإسلام أنه كرم المرأة, وأكد إنسانيتها وأهليتها للتكليف والمسئولية والجزاء ودخول الجنة #	NEG
في مثل هذا اليوم عام 1886 ولدت هذه الفتاة التي فتنت الأدباء والشعراء في عصرها! - #مي_زيادة في ذكرى مولدها …	OBJ
بإذن الله أشارك المهندس خالد عبد العزيز (رئيس المجلس القومي للشباب) في افتتاح الخيمة الرمضانية الشبابية في	NEUTRAL
المصريون يحتفلون فى ذكري #تحرير_سيناء بالتزامن مع مقتل ثلاث اشخاص ب #القاهرة #كلمة_تقدير_لجيشنا_الوطني_الأصيل_ف_عيده	OBJ
#لمى_الروقي #تغطية_ابو_امير_لسقوط_لمى تبككيي الله يرحممك يالمئ	OBJ
الوطن | فى الهند أم العجائب (2) | عمرو حمزاوي:	OBJ
93 ابوه معلق صورة عبد الناصر فهو بيعاند أبوهلكن في النهاية الأب بينحاز ضد الزعماء كلهم وبيعلق صور الشهداء بدلهم	OBJ
12 "الملتقى الأول لطلاب صناع الحياة"	OBJ
ونفس الأمر ينطبق على السياسة يجب أن تتغير نظرتنا للمعارضة من الاعتراض على سياسات السلطة إلى المنافسة الشريفة عليها عبر آليات وبرامج وأفكار	OBJ
ردا علي الدكتور يحي الجمل	OBJ
بعد احالة نوارة نجم للنيابة بتهمة تمويل اجنبي يا ترى انت فين يا احمد فؤاد نجم	OBJ
انتي اصلا مافيك فايده #كلمه_بتتقال_في_البيت_كل_يوم	NEG
الإخوان يحرقوا علم مصر ويدوسوا عليه بالأقدام #السادة_المحترمون "	OBJ
البوابة نيوز: بلاغ للنائب العام لمحاكمة "برهامي" بتهمة ازدراء الأديان: يسار_برهامي #مصر #النائب_العام	OBJ
شاهد - آخر كلام: الماء الذي يُحيي في مصر يُميت #	OBJ
أبي يا أبي ، ما المخيم يا أبي ؟ إنه بوابة للدم يا بني ذكرى اجتياح #مخيم_جنين #جني…	OBJ
خديجه الشاطر 5 ساعة · وكعادتي ألتقي بأبي الحبيب #خيرت_الشاطر مرة كل بضع شهور أذهب و الهم والأسي يعتصر قلبي	OBJ
#بيقولك_أعرف_بلدك - سوهاج، قرية أولاد حمزة	OBJ
#الداخلية_بلطجية واقعة الاعتداء على الزميلة م/ #داليا_رضوان	NEG
الرئيس عدلي منصور تتوافر فيه صفات القائد المناسب للفترة الحالية …	OBJ
لو صحت شائعة تعيين الجنزورى رئيسا للاهلى سيكون طاهر ابو زيد قد دمر الاهلى مليون مرة بقدر ما قدم اليه كلاعب	OBJ
إذا كنت أستفز الحقير فهذه نعمة من عند الله	OBJ
عرض الاسبوع 36 ألف متابع #وش_أكثر_شي_يسهرك #صيام_الإثنين #خد_موقف_من #صلاة_الوتر #فى_تويتر_تلاقى #الدمام [842861]	OBJ
46572581 ههههههههههه انا و ام ابني المستقبلية بنفتح من اكونت واحد	NEG
بعد سقوط الانقلاب سيكتب التاريخ أن مصر عاشت أسوأ وأسود أيامها من 3 يوليو 2013 والى يوم السقوط القريب ان شاء الله	OBJ
#متصدر_لاتكلمني, #النصر_الشباب, #الهلال, #اكشن_يا_دوري شجع ناديك بدون تعصب مع برنامج الايفون الرائع 56	NEG
4 كلفة الفاشية المتصاعدة في كل الجنبات، ومقولات التكفير الجاهزة، والاستعداد للعنف الذي نراه اليوم في محافظات مختلفة وأدانته بالكامل واجبة	OBJ
رمضان كريم، أعاده الله علي مصر و العالم بمزيد من الخير واحترام الكرامة الإنسانية و التضامن بين البشر عبر طبقاتهم وفئاتهم المتفاوتة	OBJ
5مسئولية رئيس الجمهورية وحكومته السياسية والتنفيذية هي حماية المدنيين وضمان حق التظاهر وضمان إتباع الشرطة لقواعد اشتباك تبتعد عن الانتهاكات	OBJ
باقي المعونة الأمريكية لهذا العام التي تم تجميدها تساوي فقط 585 مليون دولار ولكن هذه أول مرة تتجمد منذ كامب ديفيد	OBJ
عرض الاسبوع 44 ألف متابع #أذكار_المساء #بصراحه_مليت_من #خد_موقف_من #علمتني_الحياة #الحياة_تحتاج_إلى_شيئين [925981]	OBJ
و فوجئنا بالخبر منشورا في وسائل الاعلام وسنتوجه غدا الاحد الموافق 31 مارس الساعة التاسعة و النصف صباحا الى مكتب النائب العام لحضور التحقيق	OBJ
الدكتور عبد المنعم أبو الفتوح فى حلقة خاصة عن تطورات الاحداث فى مصر,بعد قليل على قناة الحياة2	OBJ
#رصد| طلاب جامعة #الأزهر بـ #المنصورة يُحمِّلون شيخ #الأزهر مسئولية تقديم الامتحانات	OBJ
يوم بدء الدراسة بالجامعات هو يوم بدء العد التنازلى لاسقاط الانقلاب	OBJ
#الكويت #السعوديه #البحرين #قطر #ا?مارات #عمان #العراق #مصر #تونس #الجزائر #المغرب #ا?ردن #السودان #لبنان 328	OBJ
يا أستاذ عمرو يا دكتور محمد فى مخرج شاب إسمه رامى الجابرى فيلمه فى إحدى مسابقات المهرجان إدع	OBJ
انشقاق عبدالله بن عباس عن علي واخذهم من بيت المال حتى قال عليه علي انه يأكل ويشرب من حرام	OBJ
جدول دعمرو حمزاوي من يوم السبت 19 نوفمبر2011 حتى يوم الخميس 24 نوفمبر2011	OBJ
إحترام الحق أهم من إحترام القانون ولا سبيل إلا بجعل القانون ينصاع للحق لكي يحترمه الناس	NEG
الان اللواء أشرف أمين -الخبير الامني- ضيف #يوسف_الحسيني في #السادة_المحترمون	OBJ
آمين من هنا للعشر الأواخر أنا في ديك الساعة يا جميل انت عارف محبتي واعجابي	POS
يتم توليد الطاقة الحديثة من 3 مصادر اساسية #المياة و #الرمال و #الهواء لذلك #أوقفوا_الفحم	OBJ
(بأي ذنبٍ قُتلت)؟! #مجزرة_رابعة_العدوية #السيسي …	NEG
وايه اللى مخلى الثوار لحد الان فى محمد محمود ولا هيه بلطجه وخلاص	OBJ
منظمات حقوق الانسان هى إيقونة الحرية الجميع سيراقب عن كثب أية محاولات غير شرعية لتشويهها الثورة ستنتصر	OBJ
* #يوم_الحساب ستكون مرغماً على إعطاء حسناتك لــ #شخص_كرهته فأغتبته	OBJ
4 نوفمبر عيد الحب للتافهين عيد ميلاد تواضروس وحددوا له محاكمة مرسي ليسجلوا 3 أهداف هاتريك بشوطة واحدة مرسي صدها	OBJ
#سحب_السفراء_من_قطر الصورة تتكلم والحديث متى #قطر_ترضخ_للضغوط_الخليجية ؟وهل بدأت جديا بالعمل لتحقيق التعهد؟	OBJ
ماذا لو حصلوا على السلاح النووي؟ #المغرب #الجزيرة # #الخبر #ليبيا # #الأردن # #دمشق #الخليج #الإمارات	OBJ
#حط_نفسك_مكان_البنت قبل ما تنزل لازم اهلك يكونوا عرفين رايح فين مين هيكون معاك هتروحو ازاى مين هترجع متى و هترجعو ازاى	OBJ
الحلقة الثامنة عشر - الجزء الثالث - فرقة صابرين	POS
#فى_عالم_موازى كان زمان زعتر هو اللى بيشيلنى و يدلعنى و يأكلنى و ينيمنى جمبه بليل =)) ! #زعتر_القط	POS
ماذا فعلت مؤسسات الدولة لشرح مسودة الدستور للأميين؟ لمن يذهب الأمي الذي سيصوت على الدستور ليفهم محتواه؟ كيف نقبل هذه المسرحية الرديئة؟	NEG
يوم هام فى مصير دستور مصر القادم	OBJ
ما بعد أردوغان #اسماعيل_ياشا #قرأت_لكم #مقال_اليوم #تركيا #اردوغان	OBJ
وكيف تكتمل صباحاتي بدونك ،بغيابك أنت تحكم عليها بالتّعليق المؤقت #صباحي لك	OBJ
سيناء "الشقيقة" - يسري فودة	OBJ
يريدون اخماد المظاهرات المطالبة بعودة #الشرعية	OBJ
الشهيد بيموت مرة واحدة و المعتقل بيموت كل يوم ,,, اللهم فك أسراهم #انا_مش_رقم	NEG
#خالد_بن_الوليد "	OBJ
#موقف_نفسي_اعيشه_مع_جوزي #موقف_نفسي_اعيشه_مع_مراتي انا من رأيى بعد الهاشتاجين دول , نطلع الجمعه على قصر الرياسة بمليونية (عايز…	NEG
أيتها القطط المتمسحة بالعسكر خوفا من الاخوان هل تطلبون الديمقراطية من الشرطة العسكرية الحرية تنتزع والشعب الذي اسقط مبارك قادرعلى الاخوان	OBJ
من العار اختصار دولة بتاريخ وحجم وقيمة وامكانات مصر فى شخص واحد مخطط يهودى فظيع	OBJ
لما بتحكي عن كل المحارم فاين #حافظ_مش_فاهم	OBJ
ليلى فتاة مسلمة ربتها جدتها المسيحية، شاهد لقاء عمرو خالد مع ليلى وجدتها	OBJ
#بالعربي #عشان_متأثره #وحشاني_فشخ #وحشني_الكلام_معاكي #وحشاني_قاعدتنا #عايزه_احكيلك_كتير #مفتقداكي	OBJ
شاهد - آخر كلام: إضرابات إضرابات إضرابات بين الثورة والسلطة #	OBJ
1 إلى هواة المزايدة في دوائر قريبة مني وأخرى بعيدة عني، أشارك في اجتماع الغد بالرئاسة لمصلحة وطنية عليا هي النيل وللحصول على معلومات محددة	OBJ
#تفه_واحده_مش_كفايه علي اللي كان بيقول الكهرباء بتروح لغزه ودلوقتي ساكت وبقي عزه	OBJ
_ أرجو أنك تقرأي المقالين دول قبل ما تتفي على حد	OBJ
#مصر #خالد_علي : السلطة تمارس إجراما سياسيا ضد الفقراء	OBJ
خليك كده: إحلم بقمع معارضيك كفرهم وخونهم واستعدي عليهم وانشغل بيهم عن خيبتك، اكتب دستور يعجبك وقوانين تحميك وسيب الغرغرينا تنهش في البلد	OBJ
بالفيديو " العليمي" لـ " #البرادعي": "شباب #الإخوان معانا" التفاصيل والفيديو عبر الرابط	OBJ
الي #حمدين_صباحي: لو أنت عاوز تحاكم #السيسي يبقي أنت ما فرقتش كتير #عن اللي حاكم #سليمان_خاطر #نقطة #مصر #الانتخابات_الرئاسية #اليوم_السابع	POS
الله من نزع ملكم لغدركم وليس السيسي الله من أذهب حكمكم لعدم إخلاصكم الله من إستبدلكم لأنكم خنتم الأمانة ووليتم من لا…	NEUTRAL
يلتقى الأن دعبدالمنعم مع سفير نيوزلندا بالقاهرة ، فى إطار لقاءات متعددة مع ممثلى الدول التى لها علاقات دبلوماسية	OBJ
الليلة، الموقف من سد النهضة مع د عمرو حمزاوي و د علاء الظواهري، يعقبه لقاء خاص مع بطل مصر و العالم في الاسكواش	OBJ
مترجعوا #مبارك و اقتلوا الشباب اللى باقى هو ده اللى ناقص يا #جيش_كامب_ديفيد #سيسى_كوهن	NEG
تطبيق الشريعة	NEG
المشاركون بمؤتمر مستقبل #التعليم يطالبون بعودة تعيين العمداء ورؤساء #الجامعات	OBJ
حلقة الغش ممنوع معايا اللي إتذاعت النهارده لسه واصلاني لو في حد يحب يتفرج عليها سلام عليكم	OBJ
بعض القضاه حدثوني أنهم متعجبون من المعوقات أمام قانون استقلال القضاء وكأنه لا توجد رغبة لوجود قضاء مستقل د عبد	OBJ
#الشعب_السعودي_الشقيق #خريجات_جامعيات_قديمات_عاطلات #الملك _ "	OBJ
عرض الاسبوع 44 ألف متابع #أذكار_المساء #بصراحه_مليت_من #خد_موقف_من #علمتني_الحياة #الحياة_تحتاج_إلى_شيئين [930473]	OBJ
"الصندوق الأسود" يكشف تسريبا لـ "#البرادعي" و "العليمي" ؟؟ #بوابة_القاهرة #مصر #السيسي	OBJ
ماهو # #هاشتاج ؟	OBJ
" رايت في عينك دمعه تخفيها عن اعين الناس وضعف ليس لك فيه حيله الله يصبرك ويربط ع قلبك #لمى_الروقي	OBJ
بيان حزب مصر القوية عن مجزرة رابعة 27-07-2013	OBJ
أي استخدام لاسمي في الترويج لمؤشرات معينة بشأن نتائج الانتخابات أو لمرشح على حساب آخرين أو لانسحابات أو خلافه هو تزييف صريح ولا صحة به	OBJ
#الموجز #طارق_لطفى يهجر #السينما بسبب #محمد_رمضان	OBJ
قال رسول الله صلى عليه وسلم: (من قرأ سورة الكهف يوم الجمعة أضاء له من النور ما بين الجمعتين)	OBJ
مصطفى جلال كاتب علر جدار زنزانه امن الدوله للذكرى الخالده مصطفى جلال صيدلة المنصوره 2014 #عبث #الحريه_لطلاب_صيدله_المن…	OBJ
انا شيميل #غرد_بمعلومة	OBJ
_ غيب تقارنى الجونة بالغردقة!	OBJ
يَسّر النبي  للمرأة طريق الوصول إلى الجنة في مقابل التزامها ومحافظتها على أربع أمور▼ #يوم_المرأة_العالمي …	OBJ
في عالم الأعمال يتحسن أداء الشركات كثيرا حينما يكون لها منافسا قويا لحرصها على تقديم أفضل ما عندها حفاظا على نموها ورضا مستخدمي ومنتجاتها	OBJ
مش كده برضه حيث كده خد دي لحد ما أشوفك على خيرصباح الفل	POS
أحياناً يكون العدو الذكي أفضل من الصديق الغبي	OBJ
صوره معبره جدا جدا جدا #السيسي_رئيسي_2014	NEG
معنديش مانع أشتغل في تنظيم المرور ده لو هيحل حاجة # #	OBJ
تعليقاً على المؤتمر الصحفى الذى يعقده الآن أحمد شفيق المرشح الرئاسى بحضور وسائل الإعلام الدعاية لنفسه ونقلته قناة الحياة على الهواء مباشرة 1	OBJ
#بلغ	OBJ
إيرلندا تحاول الكشف عن مصير 3 فتيات وأخيهم (إيرلنديين مصريين) اختطفهم بلطجية السيسي بعد مذبحة رابعة من مسجد الفتح! …	OBJ
لم تر مصر على مدار 7000 عام تظاهرات مليونية مثلما شهدت فى 30 اغسطس 2013 اربعون مليون على الاقل فى كل القرى والمدن ارحل ياسيسي	OBJ
ضرب غاز مستمر مكثف بجوار مسجد عمر مكرم	OBJ
#تفجير عبوة ناسفة على همر للجيش #الصفوي في منطقة #بادوش #الدولة_الإسلامية_في_العراق_والشام …	OBJ
": #سيسي_رئيسي #سأنتخب_السيسى_و_مش_هنزل_لمستواك #مؤيدين_السيسى_بيعملوا_فولو_لبعض #مصر #سأنتخب_السيسي "	OBJ
#في_عالم_موازي اني مخلص كل حاجة ليلة الامتحان و براجع او احل #ثانوية_عامة	OBJ
#الوفد ضبط 42 إخوانيًا فى اشتباكات بـ4محافظات اليوم: قال مركز الإعلام الأمنى، التابع لوزارة الدا #الوفد	OBJ
على أساس إنه ما كانش بيعمل اللي أمريكا عايزاه هو كمان يعني؟	OBJ
! اللى خلف ما مات!	OBJ
#سنن_نبوية || #النوافل_التي_تؤدى_في_اليوم_والليلة 1 - السنن الرواتب قال - صَلَّى اللَّهُ عَلَيْهِ وَسَلَّمَ -: (ما من عبد مسلم يصل	OBJ
من رضي بقضاء ربه، أرضاه الله بجمال قدره	OBJ
نتيجة الاستفتاء (ملف يحوي التحديثات):	OBJ
ومرسااااااه جابت نتيجة، وامرسااااه جابت نتيجة حكمتك يا رب	NEUTRAL
واحد بيسألني إحساسك إيه بعد عودة السباعي طب أقوله إيه ده؟ معلش خير هجيبلك روميرو	OBJ
جنود السيسي أحرقوا معتصمي النهضة وهم أحياء واقرؤا شهادة شاهد العيان وشاهدوا الصور #مصر	OBJ
_ اسأل عمرو اسماعيل :-)	OBJ
غدا تحل ذكرى استشهاد الشيخ عماد عفت وعلاء عبد الهادي من ضحايا الإستقرار الذي دعا إليه الإخوان والسلفيينإستقرار بطعم الدم خرب البلد للأسف	OBJ
5 سوف نشارك نحن و حزب الوسط في الجمعة القادمة و أي جمعة هدفها القضاء علي الفلول و تصحيح مسار الثورة	OBJ
السؤال لماذا يكره بعض المسلمين فى مصر الاسلام؟ تربية سيئة او علمانية وقحة او جهل وفسق ومجون	OBJ
مسلسل الموسم كامل 2013 #غموض #جريمه مشاهده #سينما #افلام #عالم_سكر # #	OBJ
~بمناسبة ان #الامتحانات قربت #لو_ده_جنان_اتجنن !! _ #اتجنن ولما تلاقي فى الامتحان سؤال مش عارف اجابته اكتب	OBJ
#الطابور_الخامس|#مصر #الوفد| الحكومة تضحك علي الشعب وترفع رغيف الخبز الله يرحم أيامك يا دكتور #باسم_عودة	OBJ
#ذات_مومنت #غرد_بصورة #من_جد	OBJ
بلغة الملاكمة الرئيس الشرعى أسقط الانقلاب بالضربة القاضية	NEG
تصديت للدعوات القائلة بأن المرأة لا يمكن ان تكون رئيسة للدولة وناديت بتساوي الحقوق بين الرجال والنساء	OBJ
تعلم التوازن فى الحياة أربع دقائق	OBJ
الميزة الوحيدة لحزب النور هو توافر مادة جيدة للبرنامج لكن انا بقول ان البلد اهم من البرنامج :)	POS
تبادل اعلاني #اخر #الاخبار #القدي	OBJ
طبيبة تدعى رندة برابعة هي من أصدرت تصاريح الدفن للمتوفين برابعة 260 شخص منهم 22 شرطة،11جثة متعفنة سبق دفنهم …	OBJ
#دكتور_جميل_القدسي_الدويك #قطر #القمح #المبرعم #يعطي #طاقة #اكبر دكتور ايهما افضل للمكتئب عشبة القمح ام	OBJ
كويز #المساحة فاكس , النوم اهم #اه_والله	OBJ
لَا حًــــوٌلَ وٌلَا قُــــوٌة إلَا بِّالَله سُبْحًانَ الله الْعَظيِم وَبِحَمْدِهْ #اذكار #غرد_بذكر_الله	NEG
والثلاثة الباقون الى العدل يشتاقون، ولكنهم لا يستطيعون، وقد مر على عمل اللجنة شهران، والاثنان مسيطران، والثلاثة متذمرون 3	OBJ
متى يارب يحكمنا رئيس يوصل الغاز إلى الشعب بسعر مخفض ويضرب إسرائيل بالغاز المسيل للدموع؟	OBJ
#انتخبوا_العرص مئات المسلمين يغادرون بانغي بمواكبة قوة دولية #مصر	OBJ
رونالدو جاهز للقاء البايرن #ريال_مدريد #كريستيانو_رونالدو	NEG
أنا ضد أنا يكون نائبي إمراة أو مسيحي من أجل دعاية انتخابية ولكن سيتم إختيار الاكفأ في كل مجال سواء # #	NEG
‏ الأسواني: كيف لمؤمنين يحرصون على الصلاة والصيام والا يفعلوا شيئا حراما او حتى مكروها أن يتحولوا الى جلادين؟! >>	OBJ
#قطر تمنح 20000 حوثي الجنسيةرابط التقرير #سحب_السفراء_من_قطر …	OBJ
وحدة الكيانات العربية هي جزء من أمنك القومي وحفاظاً على وحدة كيانك,إن لم تعي ذلك #…	NEG
100 الدكتور الأسواني لم يؤيد مرسي ولم ينتخبه وقاطع الانتخابات ودعا الى مقاطعتها في مقاله بتاريخ 4يونيو في المصري اليوم شكرًا الادمن	OBJ
صورة تجمع بين سيدي الفريق اول الشيخ محمد بن زايد المشير عبدالفتاح السيسي وكلاهما حامين الوطن #أهلا_بجيش_الكنانة …	OBJ
-ي رب ان گتبت لي فرح فاقسمه بيني وبينه"♡ #محمود	OBJ
الله حي التانى جاى 16-01-2011	OBJ
بإذن الله، ألتقيكم غداً الاثنين في السادسة مساءً في محاضرة بعنوان "جدد حياتك" في الجامعة الأمريكية بالتجمع	OBJ
التوحد و ثورة جديدة	OBJ
حجز تي شيرت #أولتراس_أهلاوي في #كفرالزيات #07 كفر_الزيات الأهلي #أهلي #كفايه_هاشتاجات :)	OBJ
دسعيد اللاوندي خبير العلاقات الدولية بمركز الأهرام الاستراتيجي ضيف #يوسف_الحسيني الآن في #السادة_المحترمون …	OBJ
2 عندي حق لكن هل أخلاقنا مثل أخلاقهم؟	NEG
فكرك هوايا دا صغير ياللي انت ناوي تدوبني #دينا_الوديدي	NEG
لا تكن امعة اذا احسن الناس احسنت واذا اساؤا اسأتحديث صحيحولا يجرمنكم شنآن قوما الا تعدلوا اعدلوا ذلك اقرب للتقوى	NEG
المجد لعاصري الليمون الذين قرروا أن يختاروا الأقل سوءا لكي لاينجح أحمد شفيق ومعارضتهم الآن لمرسي هي التي تمنحها الشرعية والشرف والمصداقية	OBJ
#زمكان - #مصر | مات من شوية عامل خبطه قطار عند مزلقان #صدفا فى #اسيوط	OBJ
3 3 3 :) #فولورز_اسلاموفيتش_بيعملوا_لبعض_فولو #فولورز_عفركوش_بيعملو_فولو_لبعض	OBJ
احناا الصوت ساعة لما تحبو الدنيا سكوت #كاريوكى	POS
أبو الفتوح|مصر بتتغير|تأخير قيام نظامنا السياسي تعتبر مشكلة أمن قومي	OBJ
#طيب_نفسي كل الناس تبقى على طبيعتها و ميكدبوش على بعض #كيوت_أوي_أنا_في_نفسي	OBJ
ندى قررت حكومة #هشام_قنديل زيادة أسعار الغاز و الكهرباء و إليكم ردود الأفعال • عمرو أديب كل دى زيادة …	NEG
أتمنى إن لايعتمد مرسي على تقارير الأجهزة أو الجماعة التي تنصح بالمزيد من الإجراءات الإستثنائية لإنها مانفعتش اللي قبلهبادر يامرسي وكن قدوة	OBJ
الثورة كانت تستحق دستورا جديدا محترما تكتبه جمعية تأسيسية منتخبة ربنا يسامح من اوقعنا في هذا المازق عموما الثورة لها جولة اخرى وستنتصر	NEUTRAL
فتاوى #برهامي تروج لاغتصاب الأمة أو السلطة	OBJ
#مصر_العربية |#عاجل| إبطال مفعول #عبوة_ناسفة بـ #شمال_سيناء	NEUTRAL
بعد التأكد من تعاقد الانقلاب مع شركة اسرائيلية لتحسين صورته فى اميركا واعادة الدعم الانقلاب يجوع شعبه ويدعم اسرائيل	OBJ
لمن لا يعرف الأستاذ فهمي هويدي سبق تكفيره منذ أكثر من 30 سنة حين أصدر كتابه القرآن والسلطانمقال مهم جدا	OBJ
خطورة اصطدام كويكب بالأرض أكبر بكثير مما نتصور - ولكن يبقى هناك أملا ما #رويترز	OBJ
"_: " #التأسيسية " على وشك الانفجار بعد عودة التهديد بالانسحاب "	OBJ
شارك معنا في برنامج بسمة أمل	OBJ
_ منطق فاشل وكاذب دول متصورين بالأسلحة وفيه ضحايا سقطوا من الشرطة في الإعتصامين مش هتعرفوا تغيروا التاريخ	NEG
668 #الراتب_مايكفي_الحاجة #الاتحاد #الهلال #النصر #الاهلي #مرسي	OBJ
#الأعلى_للجامعات يقرر السماح لقوات الأمن بالتواجد داخل #الجامعات لتأمين الامتحانات #محمد_ع	OBJ
رحم الله من قال : " أقم الدولة الإسلامية في نفسك يقيمها الله على أرضك " #حسن_البنا	OBJ
5 سيبك منه دى حلاوة روح :))) هانت	OBJ
اليوم، هو ثاني أيامنا في جوبا، عاصمة دولة جنوب السودان التي يبلغ عدد سكانها9 مليون نسمة، كثيرين منهم يتكلمون	OBJ
_88 هو نسفها لكن شوف وضع روما وفيورنتينا حاليا وشوف ﻻعبينهم ﻻعبينهم ملوك مقارنة مع ﻻعبين #ميﻻن	OBJ
شاهدة عيان: بضع مئات من الإخوان يحتشدون في المهندسين و و يغلقون شارع جامعة الدول العربية يحرقون الإطارات و يروعون الناس #مصر	OBJ
اذا حدث توافق حول المبادىء العامة للدستور سيفقد المتطرفون اكبر أسلحتهم لابد ان يقنعوا البسطاء ان الاسلام في خطر حتى يفوزوا بمقاعد الحكم	POS
#رويترز : دلائل على وجود حقل غاز طبيعي جديد قبالة سواحل #إسرائيل	OBJ
زياد بهاء الدين يسأل محمد مرسي أسئلة أتحدى مرسي أن يجيب عليها بعيدا عن الإنشاء والرغي والتقعر وحديث المؤامرات	OBJ
سنسعى في كل وقت وتحت كل الظروف ورغم كل القيود أن نكون من الذين يقولون فيعملون ويعرفون فيلزمون ويقدمون فيقبل منهم #مكملين #اثبتوا	NEG
تقرير بسيوني مثله مثل صورة سلمان شهر فبراير، صور للإعلام والعلاقات العامة والحقد والكراهية هي هي لا يغيرها شيْ #سجن_جو #البحرين #اعتقال	OBJ
خلينا العيال الصغيره تشرب سجاير #هننضف_لو	NEG
ومهما قالوا الناس ناديكوا #ضاع وخلاص هافضل وراه عـ طول دا اسم #غالى عليا ومهما يعمل فيا والله بنحبك يا #زمالك #الزمالك	OBJ
#نفسك_فى_أية_فى_الجنة_؟ اشوف الرسول علية الصلاة والسلام وكل الناس الى بحبة تبقى معايا	OBJ
اتفاق جنتلمان بيني و بين البواب: من بكره لما يسيب الجرايد قدام الباب مش هيكون الأهرام ع الوش	OBJ
_7 متعة لأن بيخليهم يفكروا	OBJ
صورة أثناء منتدي الإعلام العربي بدبي #2013	OBJ
هل دعوة #حسن_البنا اخرجت الناس من عبادة القبور الى عبادة الله ؟الشيخ #محمد_أمان_الجامي #كلنا_ال…	OBJ
المصرى اليوم صحيفة سيسي والانقلاب تعلن عن بدء تأسيس قاعدة عسكرية روسية فى مصر وشركة اسرائيلية تؤمن قنال السويس الطمى يا منى زغردى يا لميس	OBJ
خمس الاف #الامارات #الهلال #النصر #السعودية #الكويت #قطر #الرياض #مكة #رتويت # #دبي #الشارقة # #غرد_بصورة 745	OBJ
#الشروق | #مصر فى المركز الأخير "عالميًا" فى جودة المدارس وكفاءة التعليم الأساسى # #…	OBJ
لورانس رايت وجيرالد رافشون عن كامب ديفيد وهوليوود، و سامي يوسف عن الإسلام والفن آخر كلام ١١م	OBJ
لا تجعل الامتحانات تلهيك عن عن عن الامتحانات اللي بعدها ،، ما هما شهرين طين #امتحانات_ايفري_وير #عشان_خاطر_ماسر	NEG
هناك شيوع لخطاب الكراهية والإقصاء والعزل وتواري للمحبة	OBJ
الإجابة بالنفي في الحالات الثلاثة، ولا ينبغي اختطاف النقاش حول مشروع الدستور إلى ذات الاتجاه الزائف الذي اختطف به نقاش التعديلات الدستورية	OBJ
من أدركت الفارق بين الدلال والمحن فقد حازت شطر الجمال #اه_والله	OBJ
اعترافاتهم على شاشات العار بانهيار اقتصادى وفشل حكومى ومعاناة الناس اول بشائر سقوط الانقلاب	OBJ
بسبب #الخرفان مصر #خربت و #الأرهاب وصلها و #الامتحانات اتقدمت ومش عارفين نذاكر امتى #حسبى_الله_ونعم_الوكيل	OBJ
#نبض_رابعة | #ضد_الانقلاب |#حاميها_حراميها | #اوعى_تنسى #مكملين	OBJ
#السعودية #الرياض #مكة #المدينة #الدرعية صورة من الماضي الجميل لشيخ علي الطنطاوي رحمة الله في شهر رمضان بعد الافطا	NEUTRAL
حلقة اليوم كانت بداية الفتوح الإسلامية، الكثير يظنون أن الإسلام انتشر بالسيف ولكنه خطأ كبير فعدد الكنائس التي	OBJ
#الفرسان_كورة | اخبار | #محمد_صلاح يقود #تشيلسي لاسقاط #ليفربول	NEG
بيبص في الموبيل بيبص في الموبيل بيبص في الموبيل ببصله فجأه بيدور وشة #مترو	OBJ
": #قناة_تغاريد / #كليب_اسمعوني (الفرات السعدون): عبر "	NEUTRAL
__ مش قصدي عليك يا سلامة	NEUTRAL
2 فقط جلسة ودية، موقفي من رفض الحوار مع الرئيس وجماعته وحزبه كما هو وملتزم بموقف الشارع الرافض للحوار بدون ضمانات وهو موقف جبهة الإنقاذ	NEG
نعلم ما تمثله مصر لإفريقيا وندعم خارطة الطريق #السادة_المحترمون	NEG
دول وصلونا لمرحلة النفور من اي اغنية وطنية لاننا بقينا نحسها بتمجد فيهم مش ف مصر #عشان_خاطر_ماسر	OBJ
أهمها محاكمة الرئيس السابق وصناعة رأي عام مؤيد للانتصار لحقوق الشهداء والحفاظ على الضغط الشعبي للتعجيل برحيل العسكري	OBJ
كرستيانو يحصل على لقب لاعب الاسبوع في موقع جول دوت كوم ( ) #ريال_مدريد	OBJ
شبكة العملاق | رصد| نظم أهالى #المطرية الجمعة مسيرة مناهضة للانقلاب العسكري ، #25 #11 #	OBJ
وزير الداخلية يشارك فى تكريم شهداء ميدان التحرير فى 30 يونيو حكاية استحمار شعب	NEUTRAL
#الدقهلية نظم العشرات من العاملون بمستشفى الطلبة بجامعة #المنصورة وقفة إحتجاجية داخل المستشفى للمطالبة بإقالة	OBJ
جماعة الاخوان عاندت ولم تسمع لصوت الشعب #السادة_المحترمون	OBJ
أصداء الثورة التونسية قبل أن يحرق العرب أنفسهم في آخر كلام الليلة في العاشرة مساء بتوقيت القاهرة الثامنة مساء	NEG
#الجزيرة اظهرت تسجيلات غير فيها #صباحي رأيه حسب الظروف كانت أمامه فرصة ليكون محترم #مصر #الاعلام #الاخبار #الوطن #رابعة #الشروق	POS
وفاة مصطفى عبد الجليل رئيس الإنتقالي الليبي السابق في أحد مستشفيات ألمانيا # #	OBJ
توضيح: الدعوة للقاء ماكين التي رفضتها كانت من السفارة الأمريكية وليس من الغرفة الأمريكية بالقاهرة رفضت دعوة السفارة ولم أتلقى دعوة من الغرفة	OBJ
لو عمرك ما دخلت بيدج و كتبت ممكن اكون #ادمن معاكن يبقى انت كدا واد #اسطورة # 3	OBJ
"سي بي سي إكسترا":بدء المؤتمر الصحفي لتحالف التيار المدني للإعلان عن تأييده لـ #المشير #السيسي في #الانتخابات_الرئاسية #	OBJ
يا ترى إيه اللى بيشدنا كده فى مصررغم كل المشاكل الى حواليها دى؟ خفة دم شعبنا؟ طيبته؟ شهامته ؟ النيل و الشمس؟ مش عارفرغم المنغصات	POS
#ولاد_البلد #المنصورة #مصراوي #ملعب_طلخا بلقاس يتقدم بثلاثية على غزل شبين ، وطرد لاعبين من صفوف غزل شبين، في	OBJ
#الكويت #السعوديه #البحرين #قطر #ا?مارات #عمان #العراق #مصر #تونس #الجزائر #المغرب #ا?ردن #السودان #لبنان 499	OBJ
سيناء وإثيوبيا أزمات مزمنة قد تنتهي بكوارث غياب للحقيقة وانعدام للشفافية وبالتالي لا نعرف البدائل المتاحة ثم يتساءلون لماذا يتمرد المصريون	OBJ
يقولون #الدولة_الإسلامية_في_العراق_والشام المسؤولةعن #قطع المياه عن #حلب و #الحقيقة أن #جبهة_النصرة وحلفائها من قطعها	OBJ
الآن والقائمة الوطنية الموحدة تبدو هدفا بعيد المنال، لا بديل عن ضمان التنسيق السياسي بين الأحزاب والقوى الوطنية	OBJ
#اللى_رافضين_السيسى_رئيس_بيعملوا_فولوا_لبعض #جميــلة_و_صاحب_تويتر_وابورمان_وعيڈو_وبڈوی_وايمي_ولعوها #الكل_للكل #يلاااااا_تفااااعل_يجدعان	NEUTRAL
جاب م الاخر ربناابتلاهم بالحكم…	OBJ
اليوم السابع | نائب رئيس #جامعة_المنصورة: الدواعى الأمنية سبب تقديم موعد #الامتحانات	POS
لولا الانقلاب لسارت عجلة البناء والعلم والاقتصاد والحريات والقانون اسرع من احلامنا	POS
ممثل حزب النور بلجنة الخمسين يرفض الوقوف دقيقة حداد على اللواء شهيد كرداسة	OBJ
النفس أمارة بالسؤ فإن عصتك في الطاعة فاعصها أنت في المعصية الحسن البصرى	OBJ
يوسف الحسيني يفضح كذب قناة الجزيرة ويكشف تمثيل الاخوان	OBJ
أنا ضد الرقابة الإدارية على الإبداع الفني و الثقافي	POS
#الشروق غدًا محافظ الغربية يفتتح المعرض السنوي للأنشطة التربوية: يفتتح اللواء محمد نعيم، محافظ الغرب #مصر	NEG
شكرا جزيلا	NEG
#مصر_العربية |مقالات| مروة رخا تكتب: مونتيسوري مصر "4" لقراءة المقال من هنا	NEG
الشعب هو البطل، هو صاحب الإرادة، هو الذي نظم استفتاء حقيقي في الميادين على إنهاء رئاسة الدكتور مرسي، والنتيجة هي الإنهاء الفوري وبها سأتمسك!	OBJ
#دعوة_الصائم_لاترد اللهم لا تعلق قلبي بمعصية وطهر قلبي من كل حب يخالف طاعتك	OBJ
- — - عايز #الشهرة خد #شهرة - عايز تعمل #الحفلات أعمل #حفلات -عايز تبقى #مسيطر #سيطر -عايز و عايز و #عايز	OBJ
النصر سوا تيفو ٩٠ دقيقه واكل ٤ واليوم سوا انتعاش وشكلها وفاه هههههههههههههههههههههههههههههههههههههههههههههههههههههههههه #ال…	OBJ
هل نتصور ان المجلس العسكري قد فوجيء بترشيح الشاطر للرئاسة بينما هو الذى منحه العفو الصفقة واضحة اكدها الاستاذ الهلباوي الاخواني الشريف	OBJ
سيبيك منه ده كالنقش على الميه :)	OBJ
#الكويت #السعوديه #البحرين #قطر #ا?مارات #عمان #العراق #مصر #تونس #الجزائر #المغرب #ا?ردن #السودان #لبنان 358	NEUTRAL
خمس الاف #الامارات #الهلال #النصر #السعودية #الكويت #قطر #الرياض #مكة #رتويت # #دبي #الشارقة # #غرد_بصورة 810	OBJ
_ للأسف وقف :( خيرها في غيرها	OBJ
أساس انتشار الظلم هو عدم الإعتراض عليه	OBJ
أعتذر لمن كانوا ينتظرون ظهوري اليوم في ساقية الصاوي عندي أسبابي فأرجو تقديرها	OBJ
شفتو ماااااااااسر #انتخبوا_البرص ابن اليهودية رمز النجمة اليهودية #كوهين_مصر	OBJ
التراكوة "أكلونا" في كل حاجة، من أيام حسن أرابيسك اللي زخرف الأستانة لحد مهند اللي لحس مخ البنات	OBJ
#عاملان إثنان يتجاذبان #الجنان : #الحزن و #السرور على أن قطرة #حزن في عمقها توازي #بحر #سرور في اتساعه - #مي_زيادة	NEG
#عمرو_جمال #مش_رقم	OBJ
أكثر من حوار وطنى فى نفس التوقيت حول "مستقبل مصر" :خارطة الطريق تزداد تعقيداً و غموضاً وضوح الرؤية هو ركيزة الإستقرار	OBJ
#أشاهد_الآن #أوتار_القلوب على شاهدنت عبر	NEG
القبض على قيادى من حزب النور فى بنى سويف اكيد اخوان ايه المانع اهلاوى بيشجع الزمالك	NEG
نصر محروس	NEG
أ/ مجدي فريد- رئيس أحد جمعيات ذوي الاحتياجات الخاصة - : يعاني كثير من ذوي الاحتياجات الخاصة من عدم وجود فرص عمل	OBJ
2008 الشرطة التركية اليوم تفرق المظاهرات ضد اردوغان بالقوة بينما يندد هو بفض اعتصامات رابعة	NEG
مقال للأسواني بعنوان "قبل أن تدلى بصوتك فى الإعادة" يوضح اسباب مقاطعته للانتخابات بتاريخ4 يونيو2012 ميشيل جورج	OBJ
#جبهة ثوار سوريا_ القطاع الجنوبي 27_4_2014 جبهة ثوار سوريا من على قمة تل أحمر شرقي المحرر	OBJ
دعلاء الأسواني: حين نتحدث عن الفن نواجه فرق كبير بين الانسان البدائي والانسان المتحضرويتضح في	OBJ
بقالي سنين على تويتر وعدد الفلورز عندي ٥٨ عملت أكونت تاني اسمه مشاعر حائرة وكنت بحذ خواطري عليه جاب ١٥٠ في يومي	OBJ
موقف مجلس الكنائس المصرية من تطاول أردوغان على شيخ الأزهر #السادة_المحترمون	OBJ
أنا ماباحبش أقول حكاية والد علاء دي عشان بتقلل منه وحتى علاء نفسه بيزعل إن والده مش واخد حقه ككاتب عظيمصباح الورد ياعمي	OBJ
الوطن | عن ذوى الاحتياجات الخاصة | عمرو حمزاوي:	OBJ
الليلة في ندوة الأسواني بالمقطم أدهشام عيسى يعرض أفكار"سيد قطب"ومدى ملائمتها للدولة المدنية الحديثة>> التفاصيل>>	OBJ
_ يارب لا الدولة بتتراخى وأدواتها الأمنية ضعيفة والناس خائفة من الشارع لكن نسبة المشاركة العالية هتبعدنا عن العنف الانتخابي	OBJ
اللي بيتحدوني اني اجيب سيرة ده او ده انا مش محتاج اثبتلك حاجةاكبروا بقى على عبارة"اتحداك تعمل كذا"خسرت التحدي يا سيدي مبسوط؟	OBJ
لابد من استمرار الانتخابات في موعدها وترك المعتصمين والتشاور عن طريق القوى السياسية والشباب، الحل الآخر الذي أرفضه هو تشكيل حكومة إنقاذ وطنى	OBJ
وان لقاكم حبيبي سلموا لي عليه طمنوني الأسمراني عامله إيه الغربة فيه!؟ #سواح #شيرين	OBJ
صباح الجمال والعسل يا اسكندرانية #اسكندرية #الاسكندرية	OBJ
:أسرة مسلسل "ابن حلال" تنتقل للتصوير بمدينة الشيخ زايد بطولة #محمد_رمضان و #وفاء_عامر إخراج إبراهيم فخر	OBJ
المصريين الاحرار أول حزب ذو مرجعية غير دينية يقدم أوراقه للجنة الاحزاب # #	OBJ
#شيء_سمعت_عنه_بس_ما_شفته #متى_تفقد_المرأه_برستيجها #نظام_الهوامير #علمتني_الحياة خمس الاف متابع حقيقي 51	OBJ
يوما ما كان إسلاميا مقال اليوم لمن يبحثون عن حل حقيقي لمشكلة تيارات الشعارات الإسلامية	OBJ
_ لا خلاف على الغيبيات انا باتكلم في تطبيقات الدين في حياتك اليوميةاقرا التويتة كويس	OBJ
كلامي لا يخص شرعية مواجهة القذافي كلامي يخص من توقعوا أن أستمر في حواري مع ضيف الاستوديو في موضوع آخر وكأن شيئا لم يكن	OBJ
الداخلية مدمنة كذب من زمان بس لما لقت رئيس الدولة نفسه بيكذب والمسألة ماشية قالت تنزل اسطوانة حمادة حتى لو كانت واسعة ماجتش عليها يعني	OBJ
من تظاهروا دفاعاعن الدستور والعدالة الاجتماعيةوالقصاص للشهداء شرفوا ثورتهم،والذين تصدوا لهم بالعنف أهانوا جماعتهمستبقى الثورة سلمية وستنتصر	OBJ
قبل اعلان اى نتيجة هذا الاستفتاء مزور وباطل وعلى دستور باطل انتجته لجنة تأسيسية باطلة حصنها مرسي لانها غير قانونية سنسقط دستور المرشد	OBJ
لا علاوة سنوية ورفع اسعار الطاقة وكل السلع وفلوسنا 65 مليار دورلار في #سويسرا !!! #لن_ندفع_الفواتير #مصر #الاهرام #الاخبار #الوفد #الاعلام	OBJ
#بيونسيه تؤثر في العالم أكثر من #أوباما و #بوتين في القائمة السنوية لمجلة "تايم" #صباح_الخير_يا_عرب	OBJ
#إنت_حر | #كارمن_سليمان تغني للفنان الراحل #عبدالحليم_حافظ "شغلوني" مع فتابعونا #	OBJ
إخلاء سبيل #سما_المصرىوغرامة 20 ألف جنيه لاتهامها ببث قناة #فلول بدون ترخيص	OBJ
" #الإخوان" يفرشون "ملاية #رابعة" للنظام ونشطاء: صامدون ونحن نائمون #مصر #الإخوان #الإرهاب #الحكومة	OBJ
٣ تقف الآن في ٦ ابريل ٢٠١٣ مع قطاعات شعبية واسعة ضد إعادة بناء الاستبداد عبر جماعة ورئيس وحزب ينقلبون كل يوم على الشراكة والتوافق الوطنيين	OBJ
متابعة لتطورات التأسيسية يليها متابعة لتطورات حدود مصر الاقتصادية على ضوء مبادرة وزير البترول، آخر كلام، أون تي في ١١م	OBJ
رتويت تلقائي لجميع تغريداتك من حسابات حقيقيه للتواصل واتس اب 0558196947 #رتويت #فايروس_كرونا #سيف_عبدالله #ميسي #برشلونة_فيار…	OBJ
#محمد_محسن :*	OBJ
مع الانقلاب انهيار سياسي وعسكرى وامنى واقتصادى وعلمى وادبي واعلامى واجتماعى ودينى والان انهيار رياضى بكره تشوفوا مصر	OBJ
اللہم أجعل قلوبنا رقيقہ من خشيٺگ ، جميلہ بذگرڳ ، نقيہ بحبگ ! #مصطفى_حسني	NEG
#زمكان - #مصر | #حمدي_قنديل بيقول إن أفكار وتوجهات #السيسي محطوطة فى صندوق أسود وإنه لازم يكون أكثر صراحة	OBJ
مرسي يقيل طنطاوي طنطاوي يعمل انقلاب مرسي يحبسه طنطاوي يبعت دبابتين للقصر وبكري يحكي اللي ورا الكواليس وصفوت حجازي يشوف مين يكسب ويبوس ايده	OBJ
الى الشتامين الدكتور علاء لا يقرا شتائمكم لأنني اضعها اولا باول في الزبالة لو كان ذكاؤكم يماثل بذاءتكم لما كان هذا مصيركم ميشيل الادمن	OBJ
#واحد_فاضي #الهلال #السعودية #النصر #النصر_الهلال #غرد_بصوره #الرياض #زيادة_المتابعين #رتويت #هاشتاق_خاص [259150]	OBJ
الى اللاعبين والمدربين والاعلام:لا كرة قدم دون جمهور والى الجماهير:لا رياضة او متعة مع سب وعنف وشغب	OBJ
#علموا_أولادكم الثبات ع الصلاة وهما هيتعلمو كل حاجه حلوة	OBJ
علاء الاسواني: ان كراهية بعض المصريين لمواطنيهم الذين يحققون نجاحا عالميا ترجع للاسباب الاتية >>> أقرأ المقال كامل	OBJ
إياكم و المكر السيئ - معنى هام جداً نحتاجه فى هذه الأيام	NEUTRAL
81 64681296 لا مش مضبوط ما زال دعم المصانع يكلف 70 مليار أرجوك إنت تابع:	OBJ
#اعترافات_الطفولة احب كونان واحلم يرجع سينشي ونتزوج	NEG
#نجع_حمادي مسجد السيبل أقدم مساجد بهجورة صورة: صفاء ربيع #النجعاوية #ولاد_البلد #قنا	OBJ
#أنتخبوا_العرص سؤال فقيق : أنتخابات الرئاسة القادمة بين السيسي وصباحي عبارة عن تمثيلية؟ لأ دى مسرحية بطولة أتنين واحد #هاشتاج والتاني #مشتاج	NEG
#مذكرات_أبو_ليه_فى_البحث_عن_الشرعية #مذكرات_أبو_ليه_فى_البحث_عن_الشرعية #مذكرات_أبو_ليه_فى_البحث_عن_الشرعية #مرسي #سأنتخب_السيسي #تحيا_مصر	OBJ
# : شمروخ فى الايد يغنى والنار رمز احتفال وان جيت فى يوم تلومنى مش عالبال # : وتعيش الاولتراس بتحارب على مر السنين #الكورة_للجماهير	NEG
يوسف الحسيني للاخوان مش قادر استني لحد ماشوف خيبتكم الكبيرة ف 6 اكتوبر وخبتكم #السادة_المحترمون …	OBJ
مصر حسمت هويتها منذ مئات السنين بأنها دولة مسلمة وعربية وقبل ذلك بأنها أم الدنيا التى تفتح أذرعتها للجميع وتتواصل مع كل الحضارات #	NEG
782 _ _ _ و انتي طيبة يا حنان و كل الناس بخير :)	NEG
لما تتفرج على بتاع حفلة فى #سحل_حشيش #السخنة #الجونة انا سافرت بلاد الفرنجة ماشفتش	OBJ
اللغة العربية يتحدثها 350 مليون شخص حول العالم (وفقًا لآخر الأرقام في 2013)؟ #اليوم_العالمي_للغة_العربية #بالعربي	OBJ
لسنا ضد من عارض مرسي بل لسنا ضد من دعم الانقلاب لكننا ضد من دعم القتل وفوض القاتل	NEUTRAL
هذه السيدة ليست مندوبه ولا علاقة لها بالحملة والفيديو مفبرك بغرض الإساءة	OBJ
تحية تقدير وإعزاز لذلك العبقري الذي اخترع الجبنة الرومي الفكرة جت في دماغه إزاي؟	POS
الأدمن: #باسم_يوسف في ندوة يتحدث عن كيفية تطوير فكرتك إلي برنامج ناجح	OBJ
#الحقيقة_مباشر_مصر|#انقلاب_3يوليو السيسى المتخابر لخطف أول رئيس منتخب يستعين بحلفائه لدعمه بالسلاح للتصدى للإسلاميين	POS
هل تستخدم الشرطة غير العسكريين لقمع التظاهرات ولماذا ؟! الأسواني يكتب مقاله بعنوان : متى يرحل مرسي >>	NEUTRAL
سيناء علي الخريطة اكبر علامة نصر في التاريخ #تحرير_سيناء	NEUTRAL
السعودية دفعت عشرة مليارات للسلطات العسكرية للإفراج عن مبارك #مصر	OBJ
يوم 7/7، يوم هام في مشروع (العلم قوة) وهدفه جذب وتسكين 100 ألف أمي داخل الفصول، في يوم واحد، عن طريق 10 ألاف	POS
1 فى 6 اكتوبر 1973 استشهد المئات من جنود مصر البواسل برصاص اليهود وكان أعظم أيامنا	OBJ
لو عايزين إنتاجية الشعب المصري تزيد بشكل ملحوظ خلي الإخوان يدعوا للعصيان المدني أتوقع أغلب الناس هتشتغل شيفتين	NEUTRAL
الى البرادعى العظيم سيذكر التاريخ انك اول من تصدرت للنظام البائد فى عز بطشه و ساهمت بذلك فى شرارة ثورة الحرية اثق تماماً انك مستمر معنا	OBJ
#طرب_تايم #ذكرى ياحبيبي وينك انت وين انا الكمان خرررررافي	POS
أولنا فين و ليه ؟ عمرو حمزاوى - دائرة مصر الجديدة :: #	OBJ
_ بيان د/ عبد المنعم ابو الفتوح بشأن الاحداث	OBJ
شاهد - آخر كلام: جمعة الغضب لا تزال في الذاكرة #	POS
إنشغل اخوانى وزملائى بحزبى الحرية والعدالة والنور فى جمعية الدستور، بالدفاع عن شخص المهندس خيرت الشاط، أكثر من الدفاع عن المرجعية الاسلامية	OBJ
القبض على المتحدث باسم حزب #الحرية_والعدالة #محمد_ع	NEG
اهلا وسهلا	POS
ألرب واجد	NEG
#باسم_محسن مات مقتول والسيسي هو المسئول	OBJ
لا يجب على #الصين أن تقلق من الاتفاقية الأمنية المبرمة بيننا وبين الولايات المتحدة #أمريكا # …	OBJ
033 _12 _ على أساس أن تحرير #الأقصى أولوية لدى آل سعود!!	OBJ
بسمة أمل - كن من المتقين	OBJ
3 شكرا للتعديل	NEG
ومن شجاعة بديع أنه عندما إنتقب لم يخشى التحرش	OBJ
عن ال #حاجة الى جبتاها انهادة انا و فريدة عن #الانبساط الى بجد انهاردة _	OBJ
_: عاجل: القضاء الإداري يقرر وقف الانتخابات البرلمانية، وتحيل القانون إلي المحكمة الدستورية	NEG
سلاح جذب السيدات في جيش السيسي خلال إحدي المهمات الرسمية	OBJ
يا مستنى تحتفل بالفوز وتغنى تسلم الايادى يا مستنى عمرو اديب يجيب شعره اليمادى	OBJ
اللي مايعترف ان رونالدو الافضل اشك بقدراته العقلية بصراحه ،لاعب متكامل ضربات راسية وتسديد عن بعد وفاولات ومرواغ #اسطورة	OBJ
أرفض الحديث عن خروج آمن يعني حصانة للمتورطين في الانتهاكات والمزايدة هنا باقتطاع حوار تليفزيوني من سياقه رخيصة وتأتي من قوى تخجل من مواقفها	OBJ
#السعودية #الرياض #الامارات #دبي #الجبيل تسويق 11:09:54	POS
#الواتس_اب معطل؟	OBJ
في #تركيا تعمل الدولة جاهده لتفريغ 300 الف عالم للبحث العلمي للوصول الى عام 2023 وبإشراف مباشر من #اردوغان دققوا التصن…	NEUTRAL
د علاء الأسواني: ما هي آليات التحول الديموقراطي الذي تحيد عنه السلطة الحالية ؟!> أقرأ المقال كاملاً >> … … …	POS
#ولاد_البلد #المنصورة #مصراوي أهالي #المطرية يتضررون من غرق #شارع #مدرسة النصر ورعاية الأمومة بمياه #الصرف_الصحي	NEUTRAL
علاء الأسواني يكتب: الصكوك الإسلامية واحدة من كوارث كتيرة عملها حكم الإخوان فى 6 شهور >>	NEG
#نفسي	OBJ
الوطن | العزل والرئاسة | عمرو حمزاوي:	NEG
كل المجد و العرفان لكل الذين قدموا أرواحهم فداء لحرية #مصر و ثورة شعبها #ماسبيرو كفاح لا ينسى و مجرم لن يترك	OBJ
#صور إطلالة نجوم بوليوود في اليوم الختامي من #مهرجان # #شاهد ما رأيك؟ #	OBJ
هل تستخدم الشرطة غير العسكريين لقمع التظاهرات ولماذا ؟! الأسواني يكتب مقاله بعنوان : متى يرحل مرسي >> … …	OBJ
ارجو من يعرف رقم هاتف د رفعت السعيد " العظيم " ان يرسله لي او يبلغه تقديري لحديثه الشجاع مع جابر القرموطي!	OBJ
شباب الحملة بالمنيا	OBJ
2 ألف شكر	POS
أقدّر مداخلة اللواء عتمان على المستوى الشخصي لكن أسئلة كثيرة على المستوى الموضوعي لاتزال في حاجة إلى إجابات	OBJ
لا يمكن لمجتمع أن يتقدم بين قيود رقابية إلا طبعا لو أطفال إذاً أنا طفل مصري!	OBJ
من يشكك في عودة مرسي هو يشكك في وجود الله # #	OBJ
تسعين دقيقة رجولة اكسبو وفرحونا #اظن_كده_الرساله_وصلت #المصري # #بورسعيد البوستات مبقتش توصل اﻻ ل10% من	OBJ
هذا الدستور غير دستوري #المادة_لاولى	OBJ
محمد عبدالعزيز احد ممثلي الشباب في لجنة الخمسين ضيف #يوسف_الحسيني في #السادة_المحترمون …	OBJ
هل ده يرضي ربنا؟ مقال اليوم إذا آلمك ما فيه بادر إلى رد فعل للإنصاف ورفع الظلم ولو حتى بكلمة لكي لا ينالك وزر الصمت	NEUTRAL
تدهور الحالة الصحيّة لعائلات شهداء وجرحى #الثورة المضربين عن الطعام	NEG
7 متحف ساويرس للفن الحديث	OBJ
موقف #يوسف_الحسيني مع أحد شباب الإخوانإشارة رابعة وقدامها بوسة #السادة_المحترمون …	OBJ
بسمة أمل مع اسم الله العزيز	OBJ
عقود الفُل و اللهو في الحديقة وشجرة الجوافة و زهر الليمونهل تذكرين؟! عيناك تبزغان من قلب الصمت نجمتان وحياة #كلام_لها_وحدها #كلام_في_الحب	OBJ
#حط_نفسك_مكان_البنت أهو حط نفسه!	OBJ
معاك الدنيا شي ثاني معاك الدنيا اكيد احلي #تخيل الدنيا من غيرك :(	OBJ
لماذا نتمسك بانتخابات تحت اشراف دولي ؟! أقرأ المقال كاملا …	NEUTRAL
الثورة قامت ليستطيع المواطن أن يطلع على الحقيقة كاملة وأن يعبر عن رأيه بدون وصاية	OBJ
من أبطأ به عمله لم يُسرعْ به نَسَبُه #رواه_مسلم #الإسل…	OBJ
شاهد - الرجل الثالث حمدين صباحي في آخر كلام #	NEUTRAL
مقتل طفلة لبنانية في تبادل إطلاق نار بين علويين وسنة	OBJ
سكان القبور وحيدون ؛؛ أغلقت صحفهم وبدأ حسابهم، فلندعوا لهم بقدر حبنا لهم وبقدر ما تفطرت قلوبنا حزناً على فراقهم، #اللهم إرحمهم و أغفر لهم	OBJ
اليوم السابع | #الببلاوى ووزير الأوقاف ومستشار المشيخة يصلون #الكاتدرائية للتهنئة #أخبار #مصر #اليوم_السابع #	POS
اعرف بلادك - مصر أهرامات الجيزة واحدة من عجائب الدنيا تعرف على بلادنا العربيه من خلال ألبوم اعرف بلادك	OBJ
الجيش يطلق التنوير بجزيرة الرمادي بعد مواجهات عنيفة مع الثوار	POS
سـلبت مـني المـناامـ و العـقل تـوهتـه #اتجنن	NEG
بلاغ للنائب العام ضد الرئيس مرسي يطالب بالتحقيق معه فى منع دخول قضاة الدستورية المحكمة	OBJ
#القمة_الحكومية عجمان تطلق رؤيتها الاستراتيجية 2021 مبروك وحفظ الله وطننا لما تصبو إليه	OBJ
#فيفي_عبده_الام_المثالية اصلاً الأمومة محتاجة ليونة !	OBJ
_ #برهامي ومن على شاكلته مصممين يخلوا الناس تقلب #ملحدين بجد ؛ وعلى رأي #هيكل بعد فشل تجربة حكمهم : الآن البلد مهيئة لحكم شيوعي	OBJ
اعمل ايه ف ال أنا حبيته واللى القلب اختاره #عمرو_دياب	NEG
اول افاتار ع تويتر ليا كان صورته (احيه احيه احيه) #اعترافات_ليلية اللي قالوا واللي بيعمله خلوني اندم	OBJ
أعرف دستورك يوميا مع د حمزاوي فى حملة دستورنا حياتنا 4:	OBJ
محمود الجوهري هو القائد الوحيد الذي هتفت بحياته وأفتخر بذلك وهتفت بسقوطه وندمت على ذلكرحم الله محمود الجوهري رحمة واسعة	NEUTRAL
من تدليس الاخوان قولهم ان مرسي المعزول ليس مسئولا عن جرائم الشرطة التى تتبعه بنفس المنطق فان مبارك ليس مسئولا عن جرائم العادلي الا تخجلون	NEG
ماذا رأيتم من الانجغة حتي تكرهوها !!!	OBJ
أسرة مسلسل "السيدة الأولي" تنتقل للتصوير باستوديو الأهرام بطولة #غادة_عبدالرازق و #ممدوح_عبدالعليم # …	OBJ
#ﺍﻟﺸﻌﺐ_ﻳﺮﺩ_تحية_الرئيس #انتخبوا_العرص #خليك_مصدق ان #الاخوان ارهابيين بدليل ان مات منهم بعد الانقلاب اكثر من 3الاف	NEUTRAL
يامبرراتي ياللي مش مكسوف من نفسكماكانش حد هيفتح بقه لو رئيسك قال من الأول انا مااشتغلتش مع ناسا مباشرة ولاعمري رحتها كنت في جامعتي بس	NEG
حان الان وقت صلاه العصر لــ #نيويورك #امريكا 4:44 ,	OBJ
٩ ولأن البعض يسعى دائما للترويج لشائعات، حين وصلت مطار فيينا لم يتم استقبالي إلا من قبل سائق منتدى برونو كرايسكي	OBJ
شاهد - ' حزم الحرية الأمريكية #	OBJ
أخوكي ف الحبس و لسه قادرة تدافعي عن ناس تانية ف نفس الوقت ربنا يكبر قلبك كمان و كمان	OBJ
،029،542 استمارة سحب الثقه هذا هو العدد الرسمي الذي تم اعلانه اليوم في مؤتمر الحمله	OBJ
خاليك طموح متخليش معوقات الحياة تقتل طموحك متخليش معوقات الحياة تيأسك قصة أحمد نجيب (أونا) فقد حاسة	OBJ
اليوم السابع | سلاسل بشرية لأنصار #حمدين_صباحى بـ #السويس لتأييده للرئاسة	NEUTRAL
التيار السياسي المتأسلم هو إسمه كده مفيش ضرائب على الخمرة في الإسلام ولا ربا بنوك ولا تجارة مبادئ فبالتأكيد هو متأسلم وليس إسلامي	OBJ
حساسية الاسنان ! #العوامية #سيهات #صفوى #الدمام #الخبر #طب #طبيب #أطباء #مجمع_الابتسامة_الساحرة_لطب_وتقويم_الأسنان	OBJ
أم الرشراش #مصرية و #كامب_ديفيد انتقاص للسيادة #المصرية | الدستور الأصلي	OBJ
#أوباما: العقوبات الاميركية الجديدة بحق #روسيا سيُعلن عنها الاثنين	OBJ
مصر بها موارد كافيه لان تصبح دوله كبري \الصحراء وما بها من معادن كلام وكلام #يوسف_الحسيني #السادة…	OBJ
القضاء الطبيعى -من خلال تخصيص دوائر إضافية- يستطيع إنفاذ العدالة دون حاجة لمحاكم استثنائية، عسكرية أو أمن دولة طوارئ # #	NEUTRAL
قرار وزير العدل يخول الشرطة العسكرية والمخابرات الحربية الضبط القضائي ضد المدنيين	OBJ
#الشروق | إصابة 10 جنود نتيجة إطلاق مجهولين النار على سيارتي أمن مركزي بالشرقية #	NEG
النائب العام ينقل محامي عام شرق القاهرة الى بني سويف لرفضه حبس متهمي الاتحادية	OBJ
عاجل ؛ هؤلاء هم أشراف #مصر ، وكلام خطير في صميم #الاخوان !! أنصحكم بسماعه ?	POS
ولماذا تجزم ان حبك لي شيء مفيد؟	OBJ
في أول لقاء تليفزيوني له، حسن هيكل يتنصل من جمال مبارك ويدافع عن هيرميس ويشرح رؤيته لاقتصاد مصر آخر كلام ١١م	NEG
اغلقوا معبر رفح واليوم اغلقوا معبر السلوم فاضل يقفلوا مطار القاهرة ويقفلوا البلد عالرايح والجاى خربوا البلد وبرضو مش عارفين يحكموها	NEUTRAL
الأسواني : اذا قارنّا نسبة التحرش الجنسي في السعودية بالدول الأوربية كألمانيا وبريطانيا نفاجأ أن >المقال كاملاً>>	NEUTRAL
هي دي القوة الناعمة يامعلمصباح الوردعجبني شغل الجمهورية تي في جداتحياتي لبراء ولكل الأدمغة الجامدة اللي اشتغلت	OBJ
جواهر تغنى للسيسى بمؤتمر اتحاد الجاليات المصرية بأوروبا #السيسي	OBJ
بعد رفض ضياء رشوان (قطة النظام) تعديلات الدستور التى تجاهلت مقترحات نقابة الصحفيين, انتظروا فتح قضية قديمة لرشوان او اولاده, هتسكت ولا نذيع	POS
يعني 4 احزاب اسلامية فقط هي من تصوت على مسودة الدستور الان وان 65 عضو رفضوا اللعبة (من الاصل والاحتياطي)	NEG
أنا راجع من الساحل وسأسعى للحضورًباذن الله الف مبروك	NEG
اشاعة زي غيرها، ما هو موسم شكرا على السؤال عمرو	POS
المشكلة من زمان لما اكتشفنا الغاز حولنا محطات الكهربا من مازوت لغاز ده كان كويس لان السولار اغلى سبع مرات	NEG
الأسواني: كيف يتعامل نظام مرسي وأنصاره من الأسلاميين مع الأعلام المعارض لهم ؟! >> المقال كاملاً>> …	OBJ
نريد ان يستمر المشهد الحضاري الذي رأيناه في الاستفتاء رغم وجود بعض تجاوزات و تمر الانتخابات في سلام	OBJ
حد يعرف حد مهم في فودافون أحسن الموضوع بقى محتاج حد حكيم	OBJ
لو خايف على الثورة فعلا ارمي مرسي والجماعة الفاشلة ورا ضهرك وضم على صف الثورة كمواطنغير كده خلي الإرهاب ينفعك ومنك للناس الغضبانة بقى	NEG
في اول جولة الإعادة دعا الأسواني لجبهة تدعم مرسي بشروط الثورة فلما رفض الاخوان شروط الثورة دعا الى المقاطعة ومواقفه كلها منشورة وهو فخور بها	POS
السلطات تمنع الكثيرين من محامي اسر الشهداء من حضور محاكمة مبارك المحامون من حقهم حضور المحاكمة ولا ستتحول الى شيء اخر غير المحاكمة	NEG
الجولة الانتخابية للدكتور عبد المنعم أبو الفتوح أثناء مرورها بموقف الميكروباص بالحي العاشر - مدينة نصر ونقاش حولة	NEUTRAL
عملي مع #الإخوان "سبوبة"والنيابة تأمر بحبسه …	OBJ
د البلتاجي مخ	NEG
#يوسف_الحسيني عام و نصف مضى كان الواقع الثورى بمنتهى الجلاء تدفع به سيدات مصر المحروسة #السادة_المحترمون …	OBJ
#واحد_فاضي #الهلال #السعودية #النصر #النصر_الهلال #غرد_بصوره #الرياض #زيادة_المتابعين #رتويت #هاشتاق_خاص [259919]	OBJ
وزير الداخلية بلع مظاهرة 6أبريل بالملابس الداخلية ووقفت فى زوره تغريدتى عن تبنؤه باغتياله قبل 4أيام يا ترى ليه	OBJ
عاوزين نشكر مرتضى متصور لانة هيخلينا نستمتع بجمعة من غير ما نشوف فيها #باسم_طلع_حرامى وهيطلع ميتين ابونا عشان عمل الجميل دة فينا	OBJ
سبحان المعز المذل قصة علي العريض من السجن إلي وزير داخلية تونس	NEG
لا ما عرفش المشكلة إنك بتتكلم عن حمل السلاح على أساس إنه حاجة بسيطة أنا كنت بمشي لما يحصل ضرب طوب أصلاً تقول لي سلاح؟	POS
#المملكةالعربيةالسعودية #جدة #جده #الرياض #الدمام #الخبر #ينبع #الشرقية #مكة #المدينة_المنورة #راقت_لي [2138449]	NEUTRAL
قصة حقيقية من اليابان منذ عام 1938م لشاب ياباني اسمه (سوشيروا ) ولقبه سأذكره في النهاية!! كان في الصف الثالث	OBJ
اهمال إدارة المرافق العامة بما يؤدي لقتل متوالِ للمصريين جريمة تستحق العقاب الجنائي افتقاد الرؤية وبرامج الإصلاح فشل يستحق العقاب السياسي	NEG
من يعطل القانون مجرم ولا حرج في سبه	OBJ
في طريقي الي التوحيد و النور سمعت من واحد مجرب ان بطاطين النمر كفاءة	NEG
- بعد عشرين عاما ستشعر بمزيد من الأحباط ليس بسبب الأشياء التي فعلتها و لكن بسبب الأشياء التي لم تفعلها ! #مارك توين	OBJ
أنا فى الحج هذا العام بصحبة الدكتور "محمد راتب النابلسى" عالم سوريا العظيم المجاهد سندعوا كثيراً يوم عرفة	OBJ
لابد من أن نرتفع لمستوى المسئولية، فالوضع في سيناء أصبح بالغ الخطورة التكاتف لإتخاذ الإجراءات الفورية والسريعة التي أشرت لها هو الحل	OBJ
٨ بناء دولة الديمقراطية والحرية والمواطنة ووقف الجرائم والانتهاكات هو هدف ثورة الشعب السوري، ولن يتحقق الهدف هذا أبدا بالتدخل العسكري	OBJ
لابد من الإسراع بنقل الوعي الانتخابي للمواطنين، الكثير من الناس لا يعلمون القواعد للانتخابات وكيفية اختيار القائمة الحزبية والفردي	NEG
إختفاء قوات القذافي و كل مساجد طرابلس يعلو صوتها بالتكبير # #17	OBJ
تطبيق الحدالادنى والاقصى للأجور سيؤدى الى زياده البطاله كان بيعمل برنامج الطبعة الاولى دلوقتى بقى برنامج الان…	OBJ
وما كان ربك نسيا #اطمن :)	OBJ
#ماهي #علامات #محبة العبد لربه #المحبة #الحقيقية #الشيخ_حمد_العتيق - #السعودية #الكويت #الامارات #السلفية	NEG
إسعاف #مبارك إثر تعرضه لوعكة صحية أثناء محاكمته في "قضية القرن" #حسني_مبارك #مصر	OBJ
#الإخوان يشعلون النيران بنقطة مرور #الطالبية بـ #الجيزة #مصر #الإرهاب	OBJ
اليوم مولدالصادق اﻻمين اللهم صل على سيدنامحمدالفاتح لماأغلق الخاتم لماسبق ناصرالحق بالحق الهادى لطريقك المستقيم نصير المستضعفين امين	OBJ
الاكونت ده لجنة، ريبورت و سبام	OBJ
عمرو موسي زميل بانجو اكبر عقاب للعجوز المتصابي	OBJ
قال رسول الله صلى الله عليه وسلم (سيأتي على الناس زمان القابض فيه على دينه كالقابض على الجمر) #بكفي_حصار #اضبطوا_شركاء_ا…	OBJ
بقية تشكيل وزارة شفيقفائزة ابو النجا تعاون دولي احمد الزند للعدل مصطفى بكري للإعلام اسامة الغزالي للخارجية ضياء رشوان رئيسا للأهرام	OBJ
سأحاول في عمود (في أحضان الكتب) تقديم رؤية للواقع من خلال ما قرأته في الكتب على إختلاف أنواعها وسيحاول الهروب من الواقع أحيانا إلى الكتب	OBJ
#محمود درويش	NEUTRAL
الإخوان يعتدون على حفيدة مرشدهم الأسبق ويحطمون سيارتها "فحتى بيوت رموزهم لم تسلم من قلة الادب" …	NEG
الشعب يريد وعلى مجلسه أن يتصدى لهذه المهام بفاعلية وأمانة	OBJ
أبو الفتوح| بنها| عدنا إلى أهل الرأي والإستشارة في بداية تقدمنا بمشروعنا الوطني	OBJ
ألونسو وجودك ف الملعب وحده يكفي !!! #هلا_مدريد #ذا_شامبيووونز #ليلة_الابطال #ريال_مدريد "	OBJ
بوسطن تشهد أول ماراثون بعد تفجيرى 2013 #بوسطن #الولايات_المتحدة #ماراثون #الإرهاب	OBJ
يارب يا احمد يا ابن سمير يجيلك زهايمر انت و صلاح سليمان و هانى سعيد علشان تنسو نادى الزمالك ده يين و منشوفش وش اللى جبوكو تانى #زملكاوى	NEG
لمن هذا القانون؟! هل قريبا ستبيعون مصر ونصبح نحن مأجورون في بلادنا؟! وربما نحتاج ( كفيل) #عدلي_منصور #محلب	NEG
#حقيقة و #نصيحة الافكار اللي بتجيلك قبل النوم دي لازمالها ورقة و قلم عشان بجد بتبقى جامدة على المدى البعيد #اه_والله	POS
#أوباما: ليست هناك حماية كاملة لحقوق الأقلية المسلمة في #ميانمار التي لن تنجح إذا قمع المسلمون#أميركا #العرب	OBJ
الفجوة تزداد بين الشعب وحكامه لا بد من استجابة حاسمة وواضحة لمطالب الثورة	NEG
في يومٍ من الأيام قرر جميع أهل القرية أن يصلوا صلاة الاستسقاء تجمعوا جميعهم للصلاة لكن أحدهم كان يحمل معه مظلة ! تلك هي الثقة فى الله	POS
ادعو الي سبيل ربك بالحكمة و الموعظة الحسنة	OBJ
غير معقول وجود قوات جيش وصاعقة فى المدارس الصور مرعبة للعالم كله وجايين تقولو عايزين سياحة	NEG
يقبض انصار الاسلام السياسي أموالا مجهولة المصدر ثم يشترون بها الأصوات وعندما ينتقدهم احد يفتحون عليه صفيحة قمامة شتائم يعنى دجل وقلة أدب	NEG
كابوس متى ينتهى	NEG
التوافق على قيم مشتركة وخطة طريق لإنقاذ الوطن هو المخرج الوحيد مصر ملك للجميع ويجب أن نتعلم كيف نعيش جميعًًا معًا	OBJ
شوال الفلوس سويرس مشغول اوى اليومين دول بقناة الجزيرة ونازل شتيمة وتريقه فيها وفى ضيوفها خدك بيوجعك اوى ياشوال	NEG
أمي ولك في هذا اليوم دعوه ؛ حفظك الله من كل سوء ياجنتي حفظ الله أمي وأمهاتكم وجميع أمهات المسلمين #عيد_الأم …	POS
تنظيم الاخوان اصبحت اياديهم ملطخة بدماء المصريين #السادة_المحترمون	NEG
#أبو_تريكة لاعب أنجولى بأمر #فيفا	OBJ
" حبيبان نحن الى ان ينام القمر ! " #جوهرة #محمود درويش "	POS
حزب #المصريين_الأحرار يعلن تأييده للمرشح الرئاسي #المشير عبد الفتاح #السيسي	OBJ
هل قصد #ويليان و #أوسكار عدم التمرير الكرة #لمحمد_صلاح في مباراة #تشيلسي 1 × 2 #سندرلاند ؟	OBJ
طبيبٌ يداوي الناس وهو عليل قصة مأخوذة من صميم الحياة المصرية إذا صح إعتبارها حياة	NEG
#تحيا_مصر ✌ 😁 #سأنتخب_السيسي	POS
لم تعد مصر تحتمل تكرر دوائر العنف والعنف المضاد، ولم تعد أيضا تحتمل التهاوي المرعب في قدرات الدولة	NEG
الفلول والثوار يقولون الان نفس الكلام لكن يجب الا يختلط الامرالثوار ضد الاخوان من اجل الثورة والفلول ضد الاخوان من اجل السلطة لا يلتقيان	NEUTRAL
أنظر إلي خريطة أفريقيا ستجدها مثلث له ٣ رؤوس هي مصر - المغرب و جنوب أفريقيا هذه هي البوابات الثلاثة لأفريقيا	OBJ
اقبال المصريين على التصويت فى الانتخابات ضمانة لبرلمان يعبر عن الشعب ، وانتخاب ممثلين لشباب الثورة ضمانة لبرلمان يستكمل مهام ثورتنا	POS
الفيديو بتاع وجدي غنيم ريحته #فسسسس	NEG
منتخب مصر لازم يغير الفانلة بتاعتو عشان مش لايقة على شيكابالا	NEG
سوريا ترتكب بها جرائم ضد الإنسانية منذ أن بدأت انتفاضة شعبها الشقيق ومن لحظتها ومصر والعرب والعالم يتخاذلون عن نصرة السوريين	NEG
رُبّ قوم زهبوا آلى قوم فلما القوم الاولانيين لما راحوا للقوم التانيين مَ لأهومشي ، خدوا تكسي و راحوا #الفيفا	OBJ
#مصر مش تكية !!! يا #هاشتاج يا #إبن_المثالية	NEG
#أحمد_موسى ما استطاع الرد على #باسم_يوسف وقد جعله مسخرة المصريين ويتطاول فقط على #الرئيس المنتخب من شعب #مصر	NEG
قرار جمهوري بتعيين رئيس الجمهورية أصدق من انتخابات "تعبيرية" مقصور حق الترشح فيها على خمسة أفراد لنقاطع هذا العبث كفانا خداع للشعب	NEUTRAL
غزَّة إنتهى صوتها وهي تصّرخ، والجميع في / سُبات مميت !! #غزة_تحت_القصف	NEG
جيش السيسي يهدم بيوتنا؛ لإقامة منطقة عازلة بين سيناء وغزة أين أقنية التصهين؟ لا ورواري العربية يلطم، ولا منتهاه	NEG
التحقق من صدق المعلومة الإخبارية من اهم مبادئ العمل بالأعلام #السادة_المحترمون	OBJ
الى محمد عمر وأمثاله قبل ايام قليلة انتقدت الاخوان بشدة لجلوسهم مع هيكل وقلت انها خيانة للثورة والثوار والشهداء	NEG
يوم عظيم على شعب عظيم باذن الله حشود المصريين وهتافاتهم وسلميتهم تحرك الصخر النصر قادم وما النصر الا من عند الله	POS
الشرطة تاريخها كله أكاذيب لكن الاخوان لم يصدقوا في حياتهم واكاذيبهم اكثر من الشرطة ولديهم ماكينة تبرير تنكر الشمس الساطعة لابد من تحقيق	NEG
خبر عاجل الأن اشتباكات بالأسلحة النارية بين المؤيدين والمعارضين في حلوان تابعونا	OBJ
جمعية تأسيسية كافرة	NEG
شبيسى ليز اللى كان عليه طماطمية كبيرة #مقدرش_انسى	POS
انا بكره الصبح مسافر ،مدايق وفرحان واحد يقولى الاتنين اقوله اه #افكار_ع_المخده	NEUTRAL
الحكومة تفرض 1 % رسوم على الدواء وغذاء الاطفال #شاهد التفاصيل من هنا:	OBJ
من أجمل ماشاهدت في حياتي أكبر نجوم هوليود وهما عالمسرح بيتجمعوا لقراية كتاب هوارد زن عن التاريخ الشعبي لتوصيله للناس	POS
أرجو لكل من يقرأ تصريح لى أن يتأكد من مصدره و يقرأه بنفسه  قبل أن يصدر أحكامه!	OBJ
عمر سليمان قتل و تعذيب المصريين في مبني المخابرات بالوكالة عن أمريكا، و قتل إخواننا الفلسطينيين في غزة	NEG
فترة حظر التجول ستظل من السابعة مساء وليس التاسعة مساء	OBJ
الصلاة في #الأقصى تعادل ١٠٠٠ صلاة هذا ثواب الصلاة فقط لكن ثواب الوصول والجهاد ومقارعة اليهود لا يماثلها ثواب وأجر	POS
أينما وجد العدل فثم شرع الله	POS
افتتاح مشروع تخرج الدفعة الاولى من مشروع اكاديمية #الدستور	OBJ
الجيش والشرطة والحكومة والبلطجية والاعلام يلاحقون الشعب لايقافه لو انتم رجالة بصحيح اوقفوا ارتفاع الاسعار الاسعار تقفز بجنون	NEG
عاجل #حريق هائل بمصنع #نسيج في #المحلة_الكبرى أون تي في	OBJ
السيد الرئيس، وشرعيته الديمقراطية لا أنازعها وهو الرئيس المنتخب، عليه مسئوليات كبرى ويحتاج لاستقلالية وشفافية وفاعلية لم ألمحهم الى اليوم	OBJ
لو جيش او شرطه او انصار سيسى يبقى فى داهيه #مصر_الليلة	NEG
ما يجرى فى سيناء إرهاب يروح ضحيته عشرات الشهداء وخيانة لأمننا القومى ، وما يجرى فى رابعة والنهضة ظهير سياسى له	NEG
بدون استعادة الأمن وتصحيح المسار سنظل ندور حول انفسنا غارقين فى الصغائر غافلين عن التدهور الإقتصادى والإستقطاب الإجتماعى	NEG
تحية لأبطال اكتوبر وللشعب الذى ساند قواته المسلحة حتى حقق ملحمة العبور العظيم ، هذا الشعب القادر على تحقيق المعجزات سوف يحقق أهداف ثورته	POS
#يقين|#شاهد|#فيديو| حكومة الببلاوي ومحلب اعطو شرعية قانونية للفاسدين ولم يعزلو فاسد واحد	NEG
القضاء الإداري يقرر إعادة جمال عبد الرحيم لمنصبه كرئيس تحرير لصحيفة الجمهورية	OBJ
النادي الاهلي هو النادي الرسمي للدولة #المادة_لاولى	POS
قرارات مرسي إهانة للذات الشعبية والقضائية من اجل الذات الإخوانية	NEG
لكل عملة وجهان الانقلاب الدموى قتل واصاب واعتقل مائة الف مصرى لكنه كشف المعدن الحقيقي لاعظم شعوب الدنيا شاهده العالم باعجاب اليوم	NEUTRAL
رئيس المجلس الاعلى للقضاء الحالى من رموز استقلال القضاء وقد صنع مشروعا عظيما مع المستشار احمد مكي من اجل استقلال القضاء الواجب مساندته	POS
انتظروا ثورة الجياع قريبا جدا #مصر_الليلة	NEG
اجمع ٣ اعلانات دستوريه واحصل علي طائر النهضه مجانا ٠٠ هذا العرض ساري حتي ١٥ديسمبر	NEG
نحن امام انهيار لشرعية المجلس الأعلى للقوات المسلحة	NEG
لما قالها #البرادعى بقى خاين وعميل يقولها #السيسي يبقى البطل العظيم يا سلام على شعبنا لما يعرص	NEUTRAL
#عن إحساس إنك تكون في الشارع والنهار يشقشق والنور يملا الدنيا كلها ^_^	POS
الانقلاب حرق برادعى وصباحى ابو الفتوح وحزب النور الضحية القادمة من عيار ثقيل	NEG
محدش عندو #ضحكة سلف ! :( :- :-	NEG
إلتقى أمس دعبدالمنعم أبوالفتوح مع السفيرة الأسترالية بالقاهرة ستيفاني شوابسكي، جاء اللقاء لمناقشة المستجدات	OBJ
أرفض تكليف أي مسئول من الفترة الإنتقامية السابقة	NEG
باحييكي من كل قلبي على الكتاب الرائع المهم الجميل والغني بتفاصيله الحزينة والموجعة والمدهشةلو كان عصير الكتب موجود كنت احتفلت بيه	NEG
الجحش بس هو الي يبقي فاكر ان تأييد #شفيق ثم #عمر_سليمان و رجوعاً لشفيق تاني ثم #السيسي من ابناء #مبارك و فلول البلد صدفة	NEG
الملف الكامل لانتخابات الرئاسة ونتيجة اللجان الفرعية: كثير من المعلومات المهمة لمن يُعد لانتخابات مجلس الشعب	OBJ
عبد_الرحيم_علي: 30 ديسمبر القادم سيشهد اختفاء #باسم_يوسف من الساحة الإعلامية #باسم_طلع_حرامي	NEG
برميل السيسى يحكى أن سهرة رمضانية جمعت بين السيسى وعدد من الانقلابيين ، القذافى وصدام وعبد الناصر	NEG
حد يعرف رئيس الاركان الجديد من اي فرع في القوات المسلحة؟ مشاة ، مدفعية، الخ؟	OBJ
رجال الاعمال اللصوص باعوا اسهمهم من بورصة القاهرة لبورصة لندن وحولوا ارصدتهم لبنوك عالمية بيهدموا البلد بعد ما خربوها بالانقلاب	NEG
أهنئ الأساتذة والزملاء الأفاضل مؤسسى حزب الدستور، بمولودهم الجديد،اتمنى ان يكون اضافة حقيقية للحياة السياسية،وقوة دافعة لتحقيق اهداف الثورة	POS
هو المتقاعد #حمدي_قنديل هيظهر قبل كل انتخابات يلبسنا في الحيط بس ولا ايه؟ هو افتكرنا نسينا دعمه و مساندته مرسي	NEG
إقالة لبيب السباعى من الطب الشرعى وتعيين د إحسان كميل جورجي بدلاً منه" الى مزبلة التاريخ وشكرا	NEG
أعتذر عن كتابة المقال هذا الأسبوع لسفري إيطاليا وسأوافي حضراتكم تفاصيل الجولة في أقرب وقت شكراً جزيلاً	OBJ
#السيسي عروسة في إيدين #المجلس_العسكري	NEG
ألغيت المسيرات للميادين الخطرة كالتحرير و رمسيس فإذا بهم يقتلون الأطفال بالرصاص الحي في عباس العقاد و يدهسونهم بالمدرعات …	NEG
بكرة احسن ولسة في امل	POS
بعد تدمير الانقلاب لقرية دلجا فى المنيا دمروا وأحرقوا وسرقوا قرية العتامنة فى سوهاج انتظروا غضب الصعيد	NEG
مصر دوله اوضتين وصاله اوضه للمشير واوضه للمرشد والشعب ينام ف الصاله #المادة_لاولى	NEG
بتفرح اووي لما #تبقى انت السبب في #ضحكة حد انت بتعشقه :)	POS
التعامل الأمنى العنيف مع المتظاهرين وأداء الإعلام الحكومي يعيدنا لأجواء ماقبل الثورة	NEG
تحسبهم جميعا وقلوبهم شتى فهم لا يتوحدون إلا على قمع حريات الآخرين فقط	NEG
مقال رائع لخالد منتصر	POS
مؤتمر الصحفي بنقابة الصحفيين يوم الاحد 4 ديسمبر 2011 الجزء االثالث	OBJ
اليوم اختبار حقيقي لمجلس الشعب اما ان يكون على مستوى المسئولية فيكتسب الشرعية و احترام الناس وأمان ان يتواطا مع العسكري فيخسر كل شيء	NEUTRAL
#مرسي_رئيسي #انتخبوا_العرص	NEUTRAL
من تكريم الله للمرأة أن خصها بالذكر في كتابه وجعلها أول من سَعى،وأول من أسلم،وأول شهيدة وكلها أولويات رفعت من قدرها و شأنها	POS
عن الروقان اللي كانت فيه #دينا_الوديدي فـ اغنيه وحده خيااااال	POS
وطبعاً لما الداخلية تحتل المدارس لتهاجم الشعب بالموليتوف والرخام ويكسروا عفش المدرسة عشان يحدفوه على الناس كده الدولة هيبة ونحس بأمان	NEG
الرضا بماا كتبه الله لك~ يجعل لك الحياة كما تريد♡	POS
الابراشى ينتخب الشيطان لو نافس الاخوان وينتخبه لو دخل ضد الرسول الشيطان لازم ينتخب الى زيه	NEG
لو حد قال بعد كدا الإخوان مصريين أوفصيل وطنى لازم يتحاكم بتهمة الخيانة أو الغباء!!	NEG
لازم #الزمالك يكسب الشرطة و الاسماعيلى عشان يضمن الصعود اى حاجة غير كده الزمالك مش هيصعد	OBJ
#الأعلى_للجامعات يقرر السماح لقوات الأمن بالتواجد داخل #الجامعات لتأمين الامتحانات	OBJ
اليوم السابع | #جامعة_الأزهر بـ #أسيوط: 3 مايو بدء #امتحانات التخلف والشفهى	OBJ
نحن ندفع الأمل فى عقول و قلوب المصريين	POS
بمناسبة رحيل أرمسترونج أنصح بقراءة رواية ساخرة لأستاذنا العبقري أحمد بهجت إسمها تحتمس 400 بشرطة	OBJ
تنعقد الليلة الخميس الساعة السابعة مساءً ندوة دعلاء الأسواني في مركز إعداد القادة بالعجوزة	OBJ
قتلوا وحرقوا وأصابوا واعتقلوا ولاحقوا وطردوا واهانوا وشوهوا كل الشرفاء، كلنا غداً في الشارع احشد ٣٠ أغسطس لإسقاط الانقلاب	NEG
د عبد المنعم أبو الفتوح : العدل الكامل فى توزيع الثروة و الدخول ، وتنمية القدرات ، وتهيئة مناخ التشغيل الكامل	OBJ
هل من الممنوع ان يوجه احد انتقادا لقرارت المجلس العسكري الا يكفى العسكري كل هذا النفاق الرخيص في الاعلام الحكومي الثورة تحتاج جولة اخرى	NEG
خُلقت مبرءاً من كل عيبٍ ،، كأنك قد خُلقت كما تشاء #سيدنا_النبي	POS
اسمه #مرار_طافح ولسة ولسة هو احنا شوفنا حاجة :(	NEG
سي بي سي:#ابراهيم_محلب يلتقى عمال مصنع "200 حربي" بمقر رئاسة الوزراء ووفد يناقش مطالب صرف الخصومات للعاملين	OBJ
لو اجتمع غضب الانس والجن على دولة ما فعل بها من كوارث وجرائم وحوادث مثلما يفعل الانقلاب بمصر شياطين شياطين	NEG
#فيفي_عبده_الام_المثالية اصلا صارت كلمة مثاليه الحين سبه عجبكم كذا طيب امشي يابن المثاليه	NEG
الواحد كل لما يركب مترو ويجي ينزل منه بيبقي نفسه يكتب ع المترو وهو خارج البؤساء	NEG
#عدلى_منصور :مصر أخلصت فى الحرب والسلام سلام المنتصرين وأخلصت للسلام الذي التزم به الطرف الأخر	POS
#اسكندرية : محطة الرمل زمان أو دلوقت دايما جميلة :)	POS
البوء المعفن ده انا سمعته فين قبل كدا !	NEG
أم حامد ابو حامد الاخت الى بتبوس ايد البابا بتهاجم وزير الداخلية وبتهدده بأمارة أيه يا بطوطة	NEG
تجاهل مبارك للفقراء لم يكن نابعا عن إهمال فقط وإنما فلسفة تقوم على احتقار الفقراء لأنهم فشلوا فى الثراء	NEG
إبراهيم عيسى قلم شجاع وضمير يقظ وعلامة بارزة فى تاريخ المهنة تحية له ولفريق الدستور وستبقى حرية الصحافة فى مصر ثمرة مستحقة لنضال الصحفيين	POS
#علامات: من علامات موت القلب عدم الحزن على مافات وعدم الفرح على ماهو آت	NEG
من النهارده هتبتدي كل الوساخات اللي كان نظام مبارك بيرددها عن هيكل تتردد على ألسنة الإخوان وأنصارهم للإنتقام من كلامه عن فشل مرسي وجماعته	NEG
لا يوجد تيار بقوة هذا الشعب العظيم الذي قام بالثوره	POS
كم هى حقيرة الشمطاء ميرفت التلاوى عدوة الاسلام تسخر من الاسلاميين لاختيار 2 فقط في لجنة الدستور قالت:احمدوا ربنا اننا عبرناكم	NEG
وبإذن الله لن يكون للفكر الصفوي الضال أي تواجد في ارض مصر	NEG
التغييرلن ياتى الا بواسطة الشباب الحق معكم, المصداقية لديكم و المستقبل امانة فى ايديكم معا سنغير	POS
اي أمرأة تصنع الحب والايثار والاهتمام والعطف والحنان مؤهلة ان تصبح أم مثالية	POS
جووووووووول #زمااااااااالك #دومينيك	POS
قذارة الانسان تكمن فى سكوته على وساخة ماحوله من اشخاص عن #حمدين_صباحى اتحدث	NEG
اليوم انتصار للإسلام	POS
التحريض و خطاب الكراهية و المتاجرة بالدين ليست حرية رأي بل جريمة يدفع الوطن ثمنها في الشارع الآن هذه قنوات فتنة و ليست دينية	NEG
ال ع الشمال ده زييت #باسم_عودة الإرهابي أما ال ع اليمين ده زيت الإستقراااااااااااااااااااارررررررر #هز_ديلك …	NEG
بسمة أمل من المستشفى - إسعاد غيرك إسعاد لنفسك	POS
اعلام العار قلب الدنيا صراخا على خسارة المنتخب من غانا ولم ينطق على دهس سيارة للطلاب امام جامعة الازهر, شياطين فى صورة مذيعين	NEG
#الديمقراطية صنعها الغرب للتحكم فى الدول المتخلفة بأبواق متعددة مثلك انت و #توكل_كرمان لاحتلالها وزرع قواعدة فيها ولا يطبقها الغرب في بلادة	NEG
شفت السماء فوقك ؟ تخيل مداها ، بنجومها ، بأجرامها باللي فيها ! واللي خلقها من عدم واحتواها إني احبك حُب غطّى عليها #تخيل	POS
#عادل امام معاهم معاهم عليهم عليهم ‹☺›	NEG
اخبار صباحية هبوط البورصة اليومى وتراجع مؤشرها الرئيسي وخسائرالمستثمرين الباهظة بكره تشوفو مصر	NEG
زول فى الشارع للبنت و كمية شده الاعصاب اللى بتقابلها يجيب الف مشكلة نفسيه فى حد ذاته ! #مصر #تحرش	NEG
إنتا فرحة جات لِ عندي بعد دنيا من التعب السعادة إللي بعشها يَ حبيبي إنتا السبب ضحگتك عقلك جنونك والحنان إللي في عيونك #شير…	POS
الإسلام شيء غير هذا المعنى الذي أراد خصومه أن يحصروه فيه, الإسلام عقيدة وعبادة ووطن وجنسية وسماحة وقوة وخلق ومادة وثقافة	POS
بالفيديو يوسف الحسيني بيهزق الحكومة انتوا حكومه بلاميطي	NEG
#هناك_مكان_اسفل_الجحيم للي بيتفرجوا على #فيفي_عبده	NEG
كلامي لم يتغير من يستغلون الإسلام سياسيا هم من صاروا أكثر كذبا و فحشا	NEG
أفضل لاعب يالعالم يرد على المشككين بهدف آخر من ماركة #رونالدو و يعلن نفسه من الشهر الرابع أقوى المرشحين للكرة الذهبية	POS
إدارة مكتبة اسكندرية الوسخة فصلت #عمر_حاذق المعتقل في مظاهرات محاكمة قتلة #خالد_سعيد #الحرية_للجدعان	NEG
قصه قصيرة : عرف ربه فأحبه فعاش سعيداً	POS
انا #مسلم وبفتخر	POS
هدى عبد الناصر تدعو الى انتخاب احمد شفيق في مقال بالأهرام يا دكتورة هدى الا ترين الدماء على يد مرشحك ما ابعدك عن مباديء أبيك يا خسارة	NEG
#ميلان يعيش مهزلة ادارية ليس لها مثيل بتاريخه ميلان الى المجهـول ميلان الى الهاوية ميلان الى الدمار #ميلانستا	NEG
#هننضف_لو بطلنا نحكم على الناس من شكلهم و لبسهم و تمن خروجاتهم و انهم بيعرفوا انجلش ولا ﻷ !	NEG
علاقة الانقلاب بالامارات والسعودية والمساعدات مثل البلطجى وسكان الحارة والفتوة والاتاوة, اذا الحارة مادفعتش	NEG
#انتخبوا_العرص بقت مكتوبة ف كل شوارع #مصر	NEG
عزيزي #ابراهيم_محلب تغطية عجز الموازنه بزيادة الاسعار سياسة المسئول الفاشل قليل الحيله	NEG
العلّامة د جلال أمين و ماذا حدث لثورة مصر، في آخر كلام ١١م على أون تي في	OBJ
الثائر الحر #عصام_سلطان معتقل في سجون الانقلاب عصام سلطان مش رقم #انا_مش_رقم	NEUTRAL
اختيار الدكتور عمرو خالد، ضمن أكثر 10 شخصيات تأثيرًا في العمل الاجتماعي في مصر لعام 2012	POS
من الطبيعي أن تتناثر الإتهامات والتشنيعات والشتائم والرصاصات في كل إتجاه إذا كان رأس الدولة عاجزا عن إتخاذ القرار	NEG
بالصور كارثة عقارية جديدة بالاسكندرية عقار جديد يميل بدرجة 10 سم و يهدد العقارات المجاروة	NEG
#دعوه_للتفاؤل الحياة بتفاؤل و امل	POS
أحبك الذي أحببتنى فيه :)	POS
ابتسم فإن هناك من يحبك يعتني بك يحميك ينصرك يسمعك يراك هو الرحمن الرحيم	POS
#نفسي اوى اشوف مسلسل #يوميات_ونيس :)	POS
هل عرفتم كيف كان يتجول الكلب #حازم_عبد_العظيم باريحية فى يده المولوتوف والحجارة عند قصر #مرسى ؟ عصابة #السيسى كبيرة #انتخبوا_العرص اليهودى	NEG
مبادئ الشريعة الاسلامية تشمل أدلتها الكلية وقواعدها الاصولية والفقهية ومصادرها المعتبرة في مذاهب اهل السنة والجماع	OBJ
انت الوحيد اللي قلبي يبتسم لحكيك من جماله	POS
لمصر شعب يحميها رب أجعل هذا البلد آمنا مطمئنا	POS
سيادة الرئيس، أنا أحترمك بقدر احترامك للمحكمة الدستورية	POS
اخلاء سبيل قتلة الأربع بنات بتوع المنصورة، عجبا ! يفرج عن متهم في جريمة قتل بكفالة، ويعتقل غيره بدون جريرة	NEG
مايكل أوين: أعتقد أن أعظم لاعب لعب لـ ريال مدريد في كل العصور هو كريستيانو رونالدو، يليه بوشكاش #اسطورة	POS
عايز اقولك بحبك من زمان جدا #محمد_محسن	POS
تحية لشباب ٦ إبريل على جهدهم غير المسبوق في توعية الشعب من خطر عودة الفلول ؛ وتحية أخرى لهم على الحملة الرائعة (:	POS
تحية لرئيس جمهورية فنزويلا الذي انحاز بقرار إعادة سفير بلاده للقاهرة لثورة مصر وارادة شعبها وأكد على متانة وعمق العلاقات بين الشعبين	POS
و يؤكد الحزب #مصر_القوية أنه مازال في طور بناء هيكله الأساسي وإعداد كوادره، والحديث عن تحالفات انتخابية محدده الآن	OBJ
مصر لشعبها وليست لسويرس والعسكر مصر لن تنام الا عندما تعود الشرعية لن تحكموها أبدا بالرصاص والحديد والنار	NEG
الانقلاب معه الرصاص والنار والغاز والتعذيب والضرب والسجن والمال والاعلام والجهلاء والجبناء, الشعب وحده سيسقطهم جميعا بالسلمية	NEG
من لا يعرف قدر المستشار مكي وقضاة الاستقلال الأجلاء عليه ان يعود الى معركتهم العظيمة في عام 2005 ضد نظام مبارك ليعرف دورهم التاريخي للوطن	POS
سخيفة #فيفى_عبده	NEG
عندما يصبح المرشّحون لانتخابات #مصر يخافون من #برنامج_البرنامج و #باسم_يوسف فأعلم انّك في #ثورة_مزعومة و#حريّة_كاذبة	NEG
خلق جميل ثقافة الحوار وتقبل الرأي الاخر	POS
الصفحة الرسمية لصناع الحياة مصر تهنئكم بقدوم عيد الفطر المبارك كل عام وانتم بخير	POS
الأ‌مل هو تلك النافذه الصغيرة التي مهما صغر حجمها إلا‌ أنها تفتح آفاقا واسعة في الحياة	POS
#حاجات_بتفرح_في_مصر الناس الكبيره في السن اللي بتدعيلك لمجرد انك رديت سؤالهم بأدب او عديتهم الطريق	POS
كلية استغفر الله العظيم المعيدين عايزين يعملوا فيها دكاترة وبيشتغلوا علي مزاجهم #فنون_تطبيقية #دمياط	NEG
اذا عرفنا ان الذين اتخذوا قرار فض الاعتصام بالقوة لا يؤمنون باليوم الاخر ولا بالجنة ولا بالنار استراح عقلنا المندهش	NEG
صورة تجمع الساخر العظيم محمود السعدني و الاخ الأصغر الفنان صلاح السعدني	POS
فاتورة فودافون الشهر ده أوووووووووفر!!!!! ايه ده؟ ده أنا لو فاتح خطي على الصين ما تجييش نص المبلغ ده طب مش دافع!	NEG
الندوة الأسبوعية للدكتور علاء الأسواني الخميس القادم - بمركز شبابيك بالمقطم	OBJ
كل من ينزل مظاهرة بسلاح أيا كان انتماءه السياسي هو مشروع قاتل يجب محاكمته	NEG
نهنئ الشعب المصري والأمة العربية بشهر رمضان وليكن هذا الشهر فرصة للمصالحة ولتوحيد الصف وحقن الدماء	POS
شعب مصر الالفية واع وشجاع ولا يخدعه الاعلام ليس هو شعب جمال عبد الناصر الذى خدعوه بهيكل واعلامه	NEUTRAL
من الذاكره : في مثل هذا اليوم ٢٨ ابريل وقبل ١٨ سنه (عام ١٩٩٦) حقق #ميلان لقب الاسكوديتو رقم ١٥ له في تاريخه بعد فوزه على فيورنتينا ٣-١	OBJ
هذه القاعدة تعني أن الحزب قد يحصل على عدد مقاعد بالبرلمان أقل مما يتناسب مع عدد الأصوات التي حصل عليها بالانتخابات نظرا لتخصيم ممنهج	OBJ
نذكركم أنه تم تأجيل لقاء "على خطى الحبيب" الأسبوعي الذي يعقد كل خميس بمسجد المجمع الإسلامى لمدة ثلاث أسابيع	OBJ
حزب مصر الحرية، نحن في الخطوة الأخيرة ولم يعد بيننا وبين التأسيس إلا أيام دعونا نتمسك بمشروعنا ونتابع العمل شكرا	OBJ
ازاى ملكش دعوة بلبس البنت البنت اللى بتلبس لبس ديق هى اللى بتتحرش بالراجل	NEG
تسلم الايادي يا جيش بلادي و يا شعب بلادي #تحرير_سيناء من الصهاينه + الاخوان	POS
#الوفد الاثنين أول مؤتمر لجبهة مؤيدى السيسي بدمياط: أعلنت "جبهة مؤيدى السيسى" إحدى لجان الحملة #الوفد	OBJ
لدي رغبة عارمة في الانتقام لو جاءتني الفرصة سأكون اكثر شراسة منهم #اعترافات_ليلية	NEG
مصطفي بكرى النموذج الكامل للبيادة	NEG
12 مليون مصرى لم يدفعوا فاتورة الكهرباء الانقلاب ساقط اصبروا وثابروا واحشدوا واهتفوا سلميتنا سلاحنا	NEG
النائب المهندس حاتم عزام هو صاحب مشروع تعديل انتخابات رئاسة الجمهورية الخاص بالفرز فى اللجان الفرعية واعلان نتائجها وتسليمها للمندوبين	OBJ
ناقوس خطر ينبغي أن يدق لدولة متراخية باتت مؤسساتها محدودة الفاعلية	NEG
الدكتور عبد المنعم أبو الفتوح يقطع سفره و يعود من تونس غدا في الصباح الباكر ليشارك في جمعة " الثورة أولا"	OBJ
دولة #القانون #القضاء_الشامخ أوبهة سجن 42 متهما ما بين3 إلى23 عاما بتهمة"التظاهر وقطع الطريق"بالمنيا #مصر #الثورة	NEG
المصريين الأحرار لم يقدم ترشيحات للببلاوى لاختيارها بالحكومة ويرفض المحاصصة الحزبية ويؤكد على ضرورة اختيار حكومة تكنوقراط محايدة من الكفاءات	OBJ
ساويرس يطالب بمنع المظاهرات منتهى الوقاحة من احد اكبر اللصوص فى تاريخ مصر	NEG
نرجو تشريفنا فى مقر الحملة 147 ش النزهة من ميدان سانت فاتيما الدور الثانة او راسلنا على الايميل	OBJ
الهيئة_العامة #سوريا #ملخص أهم أحداث حمص المحتلة ليوم 27/ 4 / 2014 حتى الساعة	OBJ
نزلنا نأييدك ومفيش حاجة اتغيرت وبقينا مسخة للعالم	NEG
#مصر #السيسي تنتكس وتعود للعصر الحجري وحكم الغاب يحزنني حال الذين يدعمون هذه الهمجية والنازية الجديدة #مرسي #السعودية	NEG
#مرتضي_منصور يقابل #النائب_العام للمرة الثانية في أسبوع واحد	OBJ
عندما تشاهد المتسولين والذين يقتاتون من صناديق القمامة فأعلم ان هناك نظام قمعي فاسد يحكمهم #انتخبوا_العرص	NEG
مش مهم المسمي اسمها ثوره، هوجه، موجه، وكسه، نكسه المهم ان الموت و الفقر و الخسائر هما اهم انجازتها #يناير	NEG
حامدين، راضين، عليك متوكلين لك الحمّد #ربنا ف آتمم نعمتك علينا وعافيتك وسترك وآسعدنا في الدنيا والاخره	POS
هذه حقيقة رؤية ياسر برهامي ومعظم التيار السلفي للدستور وعلاقتهم بالشعب	OBJ
العناوين مسؤولية الجريدة كما يبين في الفارق بين الورقي والإلكتروني أرجو قراءة الحوار كاملا	OBJ
ماحدش من معارضي مرسي متصور إنه هيفرض على الشعب رئيس غيره بعضهم انتخبوه بس شافوه كذب وأسال دم ولازم يعتذر ويلتزم بوعوده أو يرحل ويحقن الدماء	NEG
الي جميع الناخبات و الناخبين نائب البرلمان يتحمل هم الدائرة و الوطن و لا يفرق بين من صوت لة و من لم يصوت لة	OBJ
مصر تعيش وضع مأساوي أوصال الدولة تتفكك والعنف في إزدياد النظام بشكله الحالي عاجز عن إدارة البلاد لابد من المراجعة الجذرية قبل فوات الأوان	NEG
صحيفة الجارديان البريطانية التى وصفها المسلمانى الانقلابي الخائن بالكذب توجت الأسبوع الماضي بجائزة فرونت لاين كلوب	NEUTRAL
أخص بالشكر د محمد البلتاجى الذى المت به أزمة صحية لجهوده فى تجميع الصف الوطنى لتأسيسية الدستور وأسألكم الدعاء لرجل وطنى بحق	POS
طيب اذونات الخزانة اللي الحكومة بتبيعها، مش دي ربا؟ طب الدين الداخلي، و المشروعات الممولة من البنك اللي عليها فايدة ولسه	NEG
اللجنة التأسيسية باطلة والاعلان الدستوري باطل والدستور نفسه باطل والاستفتاء سيكون باطلا أقسمتم على طاعة المرشد ونحن أقسمنا على حماية الثورة	NEG
بيان حول صدور قانون مباشرة الحقوق السياسية	OBJ
الانقلابي جورج اسحق يشكو من تعسف الانقلاب انت لسه شفت حاجة بكره تبكى بدل الدموع دم وتقول ولا يوم من ايامك يا مرسي	NEG
مذبحة جديدة بحق السعوديين الأبرياء نُفذت في #الغوطة_الشرقية على يد #الحرس_الجمهوري الأسدي الظالم فأين أنتم يا مسلمين #وا_معتصماه	NEG
قرار انسحاب البرادعي خاطىء وتوقيته خاطىء #السادة_المحترمون	NEG
عندى قمر بسهر معاه :) عندى معاد وحبيبى لغاه :( — #كاريوكى	POS
دبي للصادرات تستعرض فرص التعاون الاقتصادي مع كندا - #الإمارات #بالعربي	OBJ
وفشلت #ثورة_الانترنت زي ما فشلت ثورات كتير	NEG
رحم الله الحاضر الغائب أيقونة النضال الفلسطينى محمود درويش ، تحية ودعاء فى ذكراه	POS
أكبر خسارة خسرناها في ظل نظام مبارك هي الثروة البشرية	NEG
فى #عظمتك ملقتش كتييييير #بتكسب و تفرح #الملايين #الاهلى	POS
أعظم ما تعلمته من نظام الرئيس مبارك هو كيف ينهزم وطن دون أن يحارب وكيف يتحلل مجتمع دون أن يموت #جلال_عامر	NEUTRAL
#في_عالم_موازي اي خول من دول يتمسك فى الشارع يقلع ملط و يركب الحمار بلشقلوب و نزفه ف العشوائيات	NEG
المصري اليوم | السجن المشدد 5 سنوات وغرامة 100 ألف جنيه لعضو بـ"الإخوان" في #الأقصر	OBJ
متعودتش اشوف ف الناس غير الجمال #حمزة_نمرة	POS
ﻛﻞ عام و انتم بخير تعرفوا علي مظاهر فرحه عيد الفطر المبارك من خلال البوم صور ﻟﻴﻮﻡ العيد من جميع انحاء العالم	POS
بسمة أمل جديدة مع لذة العطاء	POS
دوركم في دعم المرشح الذي ترون انه الاصلح يجب الا يقتصر على التصويت يوم الانتخاب بل ان يكون عمليا بعمل التوكيل وبدعوة الناس لدعمه من الان	OBJ
#محافظ_القاهرة: إزالة العقارات المخالفة بالقرب من "#المحكمة_الدستورية" لحماية المواطنين	POS
مصر تواجه صعوبات شديدة لشراء الوقود مع سحب البنوك للغطاء الائتماني وفرض أقساط تأمينية عالية	NEG
فخور أني مصري اولا و اخيرا	POS
مين بين كل الناس اللي اتصدمت في تأييدهم للسيسي صدمتي في #حمدي_قنديل لا توصف!! وتأكيد على مبدأ: #أوعى_تتفاجيء !!	NEG
يا شعب مصر العظيم أيها القائد والمعلم ؛ كم أنا فخور بشرف الانتماء لك	POS
بالنسبة لقناة #فلول و الحاجة #سما_المصري اللي صدعونا بخبر القبض عليها وتراخيص وحوارات القناة لسه شغالة هو كان فيلم هندي عشان يتشهرو اكتر	NEG
الغريب في #يوسف_الحسيني انه بينتقد #ياسر_برهامي و هو اكبر برهامي انا شفته في حياتي #مصر	NEG
وصول العادلي ومساعديه إلى أكاديمية الشرطة في محاكمة القرن #مصر #ميدان_التحرير	OBJ
#السعاده ؟ ان تجد روحآ تشبهك بكل شي	POS
من لا يملك قوته لا يملك حريته وارادته السياسية	OBJ
الآن أحل ضيفاً على الإعلامية رولا خرسا في برنامج الحياة والناس على قناة الحياة 2 وحديث حول تنظيم القاعدة	OBJ
"#الهولوكوست" أبشع جريمة في التاريخ الحديث!صوتي يا انشراح على اساس ان اللي بيحصل للفلسطينيين مش مكفيه …	NEG
جميل : ان يكتشفوا حسن نوايك تجاههم بعد ظنهم السيئ وعجيب:انت تكتشف سود نواياهم وانت تعتقد انها بيضاء #بقلمي #يوسف	NEUTRAL
احضن اللى بتحبه " بكلامك " ^_^ ! - قوله كلمة حلوة #فجأة :") !	POS
#الجامعات العامة فى #النرويج تسمح للطلاب من أي مكان في #العالم بالدراسة فيها #مجاناً !	OBJ
لا يستطيع أحد إجبار مرشح على مواجهة مرشح آخر ولكل مرشح حق إعلان التحدي أمام الرأي العام الذي يمكنه استنتاج مايستنتجه	OBJ
#المملكة_العربية_السعودية تقرر تزويد #مصر بشحنات جديدة من #البنزين و #السولار	OBJ
حينما ينتصر الشعب ويشرق شمس الحرية بعد هذه الغيوم الانقلابيه يمكن ان يسترد ما سرق من #ثورة_يناير	NEUTRAL
تحية لصحفيي الدستور وشبابه في اعتصامهم من أجل حق الشعب في صحافة حرة، ولتمسكهم بقائدهم الوطني إبراهيم عيسى و"بالدستور" كصحيفة مستقلة	POS
هيئة الطيران المدني تمنح أول رخصة تشغيل دولي من مطار #الجوف إلى #القاهرة لشركة نسما بمعدل 3 رحلات أسبوعياً بداية من يونيو المقبل #عسير	OBJ
اللجنة التي وضعت تقرير بالمر كان يجب أن تشمل قانونيين متخصصين ومن دول محايدة	OBJ
المسلمانى أغلي متحدث إعلامى للرئيس وأشهر كذاب ومنافق ومضلل ومحرض تحول الى قليل الأدب ووضع معارضي الجيش في سلة القمامة كلام زبالة	NEG
هذه هي نهاية الغطرسة و العناد مرسي سقطت شرعيته منذ ديسمبر على الإخوان الآن أن يضحوا بخيرت الشاطر ويقننوا وجودهم ويظلوا في حجمهم الطبيعي	NEG
بنات عمارة انت الامل فى العيون #بنات_هندسة	POS
ماذا فعلت بمصرنا الغالية ياسيسي؟ ماذا فعلت بازهرنا الشريف يا طيب؟ 12 الف طالب ماليزى يرفضون اكمال تعليمهم	NEG
القائمة السوداء: بعض شيوخ الفضائيات الدينية الذين روجوا لأكذوبة اني ماسوني وأضافوا اليها بهائي وغيرها من الأكاذيب أيضا بحق ليبراليين آخرين	NEG
التحرش الجنسي ظاهرة لا توجد الا في مجتمع همجي مختل القيم الدين عقيدة ومعاملة وليس فقط طقوس وشعارات يجب أن ترقي العقوبة الي مستوي الجريمة	NEG
#شكرا_قطر دولة كسبت إحترام الشرفاء بمواقفها وذكائها من خلال وقوفها مع الشعوب فالكل زائلون ومن يبقى الشعوب	POS
الارهاب لادين له ولا ارض #الارهاب سوس ينخر فى عظام الوطن وجب علينا جميعا محاربته	NEG
كلما رأيت أطفالا مشردين ، جائعين ، محاصرين ، لاجئين ، نازحين ، أشعر بالخيانة ، الخيانة فقط #سوريا #أطفال_سوريا …	NEG
#اﻷهلى هو اللى دايما مفرحنى الحمد لله على نعمة انى #أهلاوى	POS
آن الأوان ترحلي يادولة العكاكين	NEG
بعد فضيحة التعاقد مع شركة اسرائيلية لحماية قناة السويس مصطفى بكرى يؤلف كتابا عن دور الاخوان فى المهزلة	NEG
ثلاثين يونيو موجة ثورية ضد الفاشل مرسي والجماعة الكذابة ما أرفضه هو القمع والعقاب الجماعي كفاية كذب وخداع للنفس	NEG
الوطن | أسباب رفض الحوار وسبل تجاوزها | عمرو حمزاوي	OBJ
مجهولون يشعلون النار في سيارتين بـ #المحلة_الكبرى -	OBJ
الشوكولاته والقهوه ، فيروز وحليم ، الشتا والليل ، وانت #حاجات_بتفرح	POS
تدوينة رائعة من خالد بهي الدين ترد على أكاذيب نظام مبارك جماعة الإخوان الكذابين لن تسقط بترويج الأكاذيب عنها	NEUTRAL
#خلق_جميل الاحسان الى الجار	POS
مداخلة نجيب ساويرس مع الإبراشيي وتعليقه على إستقالة دالبرادعي وأحداث مصر	POS
#سيدنا_النبي كان طيب الرائحة، وإذا صافحه أحد ظل بيده عطره سائر اليوم صلى الله عليك يا سيدي يا رسول الله	POS
صوره جميله لعشب استاد #الامارات ! #ارسنال "	POS
مبرووووك ل#سواريز فاز بجائزة #أوسكار بعد آدائه الرائع في عدت #أفلام !	POS
الاخوان سيضاعفون اعتصاماتهم الإجرامية وغاراتهم المسلحة لأنهم تحت حماية امريكا وحكومتنا تتفرج وتحدثناعن اهمية التسامح طبقوا القانون اوارحلوا	NEG
البنزين دونت ميكس ويذ الكحول زي الضمير دونت ميكس ويذ الإخوان مرسي اول انجليش مرسي اول ذي تايم	NEG
الحكومة الحالية غير قادرة على إتخاذ قرارات وهي حكومة مرتعشة	NEG
حكومة #مصر توافق على ترخيص 50 قناة تنصيرية بينما تغلق 20 قناة إسلامية! التنصير أحسن من الإخوان! …	NEG
بعض الناس ينطبق عليهم القول لو أمطرت السماء حرية هناك عبيد سترفع الشمسية !!	NEG
وزير البترول المصري، م أسامة كمال، وحوار خاص حول استكشافات البحر المتوسط و شؤون الطاقة آخر كلام، أون تي في ١١م	OBJ
اقرا ؟ خطر مشاهدة الافلام الاباحية _تفتك الدماغ	NEG
ذكرى استعادة #سيناء ستمثل عيدا للعسكرية والدبلوماسية المصرية	POS
ما يقال عن صدور "مذكرة تفسيرية" للإعلان الدستوري "ضحك على الذقون	NEG
بالفيديو عاكشة: والله هيفاء وهبى ست مش طرية واللى يتجوزها يبقى خد خازوق #مصر #توفيق_عكاشة	NEG
مرسى لم يعد رئيسًا لخروجه على الشرعية وقراراته غير ثورية	NEG
والغاز مش مدعوم يا إنسان؟ وماذا عن الأسمنت والحديد والأسمدة؟ واضح أنك تفهم أقل من الحيوان	NEG
اغلاق كل الساحات والميادين الكبرى لمنع صلاة العيد وصمة عار على الانقلاب وحسابهم فى الاخرة عسير	NEG
#الشروق "الداخلية": 400 ألف مواطن تقدموا لأداء الحج وبدء إجراء القرعة 10 مايو المقبل	OBJ
#هتحبك_لو صحتها من النوم علشان تقولها بحبك ;)	POS
كل شى كتبته غلط كل شى حسبته غلط فى #الامتحانات	NEG
